And we're going to tell you some stories from the sea here in video.	Wir werden Ihnen einige Geschichten über das Meer in Videoform erzählen .
We've got some of the most incredible video of Titanic that's ever been seen, and we're not going to show you any of it.	Wir haben ein paar der unglaublichsten Aufnahmen der Titanic , die man je gesehen hat , , und wir werden Ihnen nichts davon zeigen .
The truth of the matter is that the Titanic -- even though it's breaking all sorts of box office records -- it's not the most exciting story from the sea.	Die Wahrheit ist , dass die Titanic – obwohl sie alle Kinokassenrekorde bricht – nicht gerade die aufregendste Geschichte vom Meer ist .
And the problem, I think, is that we take the ocean for granted.	Ich denke , das Problem ist , dass wir das Meer für zu selbstverständlich halten .
When you think about it, the oceans are 75 percent of the planet.	Wenn man darüber nachdenkt , machen die Ozeane 75 % des Planeten aus .
Most of the planet is ocean water.	Der Großteil der Erde ist Meerwasser .
The average depth is about two miles.	Die durchschnittliche Tiefe ist etwa 3 Kilometer .
Part of the problem, I think, is we stand at the beach, or we see images like this of the ocean, and you look out at this great big blue expanse, and it's shimmering and it's moving and there's waves and there's surf and there's tides, but you have no idea for what lies in there.	Ein Teil des Problems ist , dass wir am Strand stehen oder Bilder wie dieses hier sehen und auf die riesige blaue Weite schauen , und sie schimmert und bewegt sich , es gibt Wellen , Brandung und Gezeiten , aber wir haben keine Ahnung , was darin verborgen ist .
And in the oceans, there are the longest mountain ranges on the planet.	In den Ozeanen befinden sich die längsten Gebirgszüge des Planeten .
Most of the animals are in the oceans.	Die meisten Tiere leben in den Ozeanen .
Most of the earthquakes and volcanoes are in the sea, at the bottom of the sea.	Der Großteil der Erdbeben und Vulkanausbrüche spielt sich im Meer ab – am Meeresboden .
The biodiversity and the biodensity in the ocean is higher, in places, than it is in the rainforests.	An einigen Stellen ist die Vielfalt und die Dichte des Lebens im Ozean höher als in den Regenwäldern .
It's mostly unexplored, and yet there are beautiful sights like this that captivate us and make us become familiar with it.	Das meiste ist unerforscht , und doch gibt es Schönheiten wie diese , die uns fesseln und uns vertrauter mit ihm machen .
But when you're standing at the beach, I want you to think that you're standing at the edge of a very unfamiliar world.	Aber wenn Sie am Strand stehen , möchte ich , dass Sie sich vorstellen , an der Grenze zu einer unbekannten Welt zu stehen .
We have to have a very special technology to get into that unfamiliar world.	Wir müssen uns schon einer sehr speziellen Technik bedienen , um in diese unbekannte Welt vorzudringen .
We use the submarine Alvin and we use cameras, and the cameras are something that Bill Lange has developed with the help of Sony.	Wir benutzen das Unterseeboot Alvin und Kameras , und diese Kameras hat Bill Lange mit Hilfe von Sony entwickelt .
Marcel Proust said, "The true voyage of discovery is not so much in seeking new landscapes as in having new eyes."	Marcel Proust hat einmal gesagt: "Die wahre Entdeckungsreise besteht nicht darin , dass man neue Länder sucht , sondern dass man neue Augen hat ."
People that have partnered with us have given us new eyes, not only on what exists -- the new landscapes at the bottom of the sea -- but also how we think about life on the planet itself.	Die Menschen , die mit uns zusammengearbeitet haben , gaben uns neue Augen , nicht nur , um das zu sehen , was existiert – die neuen Länder auf dem Meeresboden – sondern auch , um über das Leben auf diesem Planeten nachzudenken .
Here's a jelly.	Das ist ein Weichtier .
It's one of my favorites, because it's got all sorts of working parts.	Es ist einer meiner Lieblinge , weil es alle möglichen Funktionsteile hat .
This turns out to be the longest creature in the oceans.	Es hat sich als das längste Wesen im Meer erwiesen .
It gets up to about 150 feet long.	Es wird bis zu 50 Meter lang .
But see all those different working things?	Sehen Sie all die unterschiedlichen Teile ?
I love that kind of stuff.	So was mag ich .
It's got tentacles dangling, swirling around like that.	Es hat Tentakel , die so herumschwirren .
It's a colonial animal.	Es ist eine Kolonie von Tieren .
These are all individual animals banding together to make this one creature.	Das sind alles einzelne Lebewesen , die sich zu diesem einen Organismus zusammenschließen .
And it's got these jet thrusters up in front that it'll use in a moment, and a little light.	Es hat vorne diese Antriebsdüsen , die es gleich benutzt , und ein kleines Licht .
If you take all the big fish and schooling fish and all that, put them on one side of the scale, put all the jelly-type of animals on the other side, those guys win hands down.	Wenn man alle großen Fische und Fischschulen und all das nimmt und auf die eine Seite der Waage legt und alle Weichtiere auf die andere Seite , gewinnen die hier haushoch .
Most of the biomass in the ocean is made out of creatures like this.	Der Großteil der Biomasse im Meer besteht aus Geschöpfen wie diesem .
Here's the X-wing death jelly.	Hier ist das X-Wing-Todes-Weichtier .
The bioluminescence -- they use the lights for attracting mates and attracting prey and communicating.	Sie benutzen die Biolumineszenz , um Geschlechtspartner anzulocken , Beute zu ködern und zur Verständigung .
We couldn't begin to show you our archival stuff from the jellies.	Wir hätten niemals die Zeit , Ihnen all unser Archivmaterial von den Weichtieren zu zeigen .
They come in all different sizes and shapes.	Es gibt sie in den unterschiedlichsten Größen und Formen .
We tend to forget about the fact that the ocean is miles deep on average, and that we're real familiar with the animals that are in the first 200 or 300 feet, but we're not familiar with what exists from there all the way down to the bottom.	Wir vergessen leicht , dass das Meer durchschnittlich mehrere Kilometer tief ist und dass wir nur die Tiere wirklich kennen , die in den oberen hundert Metern leben , aber was zwischen dort und dem Meeresboden lebt , ist uns nicht vertraut .
And these are the types of animals that live in that three-dimensional space, that micro-gravity environment that we really haven't explored.	Diese Tierarten leben in einem dreidimensionalen Raum , einem Mikrogravitationsraum , den wir überhaupt noch nicht erforscht haben .
You hear about giant squid and things like that, but some of these animals get up to be approximately 140, 160 feet long.	Man hört von Riesenkalmaren und so etwas , aber einige dieser Tiere werden bis zu etwa 50 Meter lang .
They're very little understood.	Man weiß sehr wenig über sie .
This is one of them, another one of our favorites, because it's a little octopod.	Das ist eines von ihnen , noch einer unserer Lieblinge , denn es ist ein kleiner Oktopus .
You can actually see through his head.	Man kann ihm tatsächlich durch den Kopf gucken .
And here he is, flapping with his ears and very gracefully going up.	Und hier wackelt er mit den Ohren und steigt sehr anmutig nach oben .
We see those at all depths and even at the greatest depths.	Wir finden sie in allen Tiefen und sogar in die tiefsten Tiefen .
They go from a couple of inches to a couple of feet.	Sie sind von wenigen Zentimetern bis hin zu ein paar Metern lang .
They come right up to the submarine -- they'll put their eyes right up to the window and peek inside the sub.	Sie kommen bis ans U-Boot heran – sie kommen mit den Augen ans Fenster und gucken ins U-Boot .
This is really a world within a world, and we're going to show you two.	Es ist eine eigene Welt in der Welt , und wir werden Ihnen zwei zeigen .
In this case, we're passing down through the mid-ocean and we see creatures like this.	In diesem Fall bewegen wir uns durch die Ozeanmitte nach unten und sehen solche Kreaturen .
This is kind of like an undersea rooster.	Das hier ist eine Art Unterwasser-Hahn .
This guy, that looks incredibly formal, in a way.	Der hier , der irgendwie unglaublich förmlich aussieht .
This is basically scientific data that you're looking at.	Was sie hier sehen , sind im Grunde wissenschaftliche Daten .
It's footage that we've collected for scientific purposes.	Es sind Aufnahmen , die wir zu Forschungszwecken gemacht haben .
And that's one of the things that Bill's been doing, is providing scientists with this first view of animals like this, in the world where they belong.	Das ist auch etwas , das Bill macht , Wissenschaftler mit den ersten Bildern von diesen Tieren zu versorgen , in ihrer natürlichen Umgebung .
They don't catch them in a net.	Sie fangen sie nicht mit einem Netz .
They're actually looking at them down in that world.	Sie sehen sie sich da unten in dieser Welt an .
We're going to take a joystick, sit in front of our computer, on the Earth, and press the joystick forward, and fly around the planet.	Wir nehmen einen Joystick , sitzen vor unserem Computer an Land , drücken den Joystick nach vorn und fliegen um den Planeten .
We're going to look at the mid-ocean ridge, a 40,000-mile long mountain range.	Wir werden uns den mittelozeanischen Rücken ansehen , ein 64 .000 Kilometer langer Gebirgszug .
The average depth at the top of it is about a mile and a half.	Die durchschnittliche Tiefe der Gipfel ist etwa 2 ,5 Kilometer .
And we're over the Atlantic -- that's the ridge right there -- but we're going to go across the Caribbean, Central America, and end up against the Pacific, nine degrees north.	Jetzt sind wir über dem Atlantik – das da ist der Rücken – , werden die Karibik , in Mittelamerika überqueren und im Pazifik ankommen , neun Grad nördlicher Breite .
We make maps of these mountain ranges with sound, with sonar, and this is one of those mountain ranges.	Wir erstellen Karten dieser Gebirgszüge mit Hilfe von Schall , Sonar , und das ist einer dieser Gebirgszüge .
We're coming around a cliff here on the right.	Wir biegen um eine Klippe hier rechts .
The height of these mountains on either side of this valley is greater than the Alps in most cases.	Die Höhe dieser Berge auf beiden Seiten des Tals ist größer als die der Alpen in den meisten Fällen .
And there's tens of thousands of those mountains out there that haven't been mapped yet.	Und es gibt zehntausende von Bergen hier draußen , die auf keiner Karte verzeichnet sind .
This is a volcanic ridge.	Das ist ein vulkanischer Rücken .
We're getting down further and further in scale.	Wir tauchen immer tiefer und tiefer .
And eventually, we can come up with something like this.	Und schließlich kommen wir auf so etwas wie das hier .
This is an icon of our robot, Jason, it's called.	Das ist ein Bild unseres Roboters – er heißt Jason .
And you can sit in a room like this, with a joystick and a headset, and drive a robot like that around the bottom of the ocean in real time.	Man kann in einem Raum wie diesem sitzen , mit einem Joystick und einem Headset und so einen Roboter ohne Zeitverzögerung auf dem Meeresboden herumfahren lassen .
One of the things we're trying to do at Woods Hole with our partners is to bring this virtual world -- this world, this unexplored region -- back to the laboratory.	Unter anderem versuchen wir mit unseren Partnern bei Woods Hole , diese virtuelle Welt – diese Welt , dieses unerforschte Gebiet – ins Labor zu holen .
Because we see it in bits and pieces right now.	Denn wir sehen sie bisher nur stückweise .
We see it either as sound, or we see it as video, or we see it as photographs, or we see it as chemical sensors, but we never have yet put it all together into one interesting picture.	Wir nehmen sie entweder als Geräusch war oder als Video oder auf Fotos oder mit Hilfe von chemischen Sensoren – doch wir haben die Teile bisher nicht zu einem interessanten Bild zusammengesetzt .
Here's where Bill's cameras really do shine.	Hier brillieren Bills Kameras richtig .
This is what's called a hydrothermal vent.	Das hier nennt man eine hydrothermale Quelle .
And what you're seeing here is a cloud of densely packed, hydrogen-sulfide-rich water coming out of a volcanic axis on the sea floor.	Und hier sieht man eine Wolke von dichtem hydrogensulfidreichem Wasser , das aus einer vulkanischen Längsachse am Meeresboden tritt .
Gets up to 600, 700 degrees F, somewhere in that range.	Es wird bis zu etwa 300 Grad Celsius heiß .
So that's all water under the sea -- a mile and a half, two miles, three miles down.	Das ist also alles Wasser unter dem Meer – zwei , drei , vier Kilometer in der Tiefe .
And we knew it was volcanic back in the '60s, '70s.	Wir wussten bereits in den 60ern und 70ern , dass es vulkanisch ist .
And then we had some hint that these things existed all along the axis of it, because if you've got volcanism, water's going to get down from the sea into cracks in the sea floor, come in contact with magma, and come shooting out hot.	Damit hatten wir einen Hinweis , dass es diese Quellen entlang dieser Achse gibt , denn wenn es Vulkanismus gibt , dringt Wasser in die Spalten am Meeresboden , trifft auf Magma und tritt siedend heiß wieder aus .
We weren't really aware that it would be so rich with sulfides, hydrogen sulfides.	Uns war nicht bewusst , dass es so reich an Hydrogensulfiden ist .
We didn't have any idea about these things, which we call chimneys.	Wir hatten keine Ahnung von diesen Dingern , die wir Schornsteine nennen .
This is one of these hydrothermal vents.	Das ist eine dieser hydrothermalen Quellen .
Six hundred degree F water coming out of the Earth.	300 Grad heißes Wasser tritt aus der Erde .
On either side of us are mountain ranges that are higher than the Alps, so the setting here is very dramatic.	Auf beiden Seiten liegen Gebirgszüge , die höher als die Alpen sind , diese Gegend hier ist also sehr dramatisch .
The white material is a type of bacteria that thrives at 180 degrees C.	Das Weiße ist eine Bakterienart , die bei 180 Grad Celsius gedeiht .
I think that's one of the greatest stories right now that we're seeing from the bottom of the sea, is that the first thing we see coming out of the sea floor after a volcanic eruption is bacteria.	Ich finde , eine der größten Geschichten , die wir gerade auf dem Meeresgrund entdecken , ist , dass das Erste , das wir nach einem Vulkanausbruch am Meeresboden wieder finden , Bakterien sind .
And we started to wonder for a long time, how did it all get down there?	Lange haben wir uns gefragt: Wie sind die alle da unten hingekommen ?
What we find out now is that it's probably coming from inside the Earth.	Inzwischen haben wir herausgefunden , dass sie wahrscheinlich aus dem Erdinneren gekommen sind .
Not only is it coming out of the Earth -- so, biogenesis made from volcanic activity -- but that bacteria supports these colonies of life.	Sie kommen nicht nur aus der Erde – vom Vulkanismus angestoßene Biogenese – Bakterien unterstützen auch diese Kolonien des Lebens .
The pressure here is 4,000 pounds per square inch.	Der Druck beträgt hier 800 kg pro Quadratzentimeter .
A mile and a half from the surface to two miles to three miles -- no sun has ever gotten down here.	2 ,5 bis 3 oder 5 Kilometer unter der Oberfläche – kein Sonnenstrahl ist jemals bis hierher vorgedrungen .
All the energy to support these life forms is coming from inside the Earth -- so, chemosynthesis.	Die ganze Energie , die diese Lebewesen antreibt , kommt aus dem Erdinneren – Chemosynthese also .
And you can see how dense the population is.	Und Sie sehen , wie dicht das Leben hier ist .
These are called tube worms.	Das hier sind Röhrenwürmer .
But they have two types of gill structures.	Aber sie haben zwei Arten von Kiemenstrukturen .
One for extracting oxygen out of the deep-sea water, another one which houses this chemosynthetic bacteria, which takes the hydrothermal fluid -- that hot water that you saw coming out of the bottom -- and converts that into simple sugars that the tube worm can digest.	Eine für das Aufnehmen von Sauerstoff aus dem Meerwasser und die andere beherbergt diese chemosynthetischen Bakterien , die die hydrothermale Flüssigkeit – das heiße Wasser , das Sie aus dem Boden schießen sahen – in einfache Zucker verwandelt , die der Röhrenwurm verdauen kann .
You can see, here's a crab that lives down there.	Sie können sehen – hier ist eine Krabbe , die dort unten lebt .
He's managed to grab a tip of these worms.	Sie hat ein Stück dieser Würmer zu fassen gekriegt .
Now, they normally retract as soon as a crab touches them.	Normalerweise ziehen sie sich zurück , sobald eine Krabbe sie berührt .
So, as soon as a crab touches them, they retract down into their shells, just like your fingernails.	Sobald also die Krabbe sie berührt , ziehen sie sich in ihre Schalen zurück , so wie Fingernägel .
There's a whole story being played out here that we're just now beginning to have some idea of because of this new camera technology.	Da spielt sich eine ganz komplexe Geschichte ab , die wir gerade erst zu verstehen beginnen , dank der neuen Kameratechnologie .
These worms live in a real temperature extreme.	Diese Würmer leben in einem echten Temperatur-Extrem .
Their foot is at about 200 degrees C and their head is out at three degrees C, so it's like having your hand in boiling water and your foot in freezing water.	Ihre Füße sind etwa 200 Grad Celsius heiß und ihre Köpfe da draußen sind etwa drei Grad kalt , es ist also , als hätten Sie Ihre Hand im kochenden und Ihren Fuß in Eiswasser .
That's how they like to live.	So gefällt ihnen das Leben .
This is a female of this kind of worm.	Das ist ein Weibchen dieser Wurmart .
And here's a male.	Und das ist ein Männchen .
Everything you see is played out in the pitch black of the deep sea.	Alles , was Sie sehen , findet in der Finsternis der Tiefsee statt .
There are never any lights there, except the lights that we bring.	Es gibt hier keine Lichtquellen außer denen , die wir mitbringen .
Here they go.	Jetzt geht's los .
On one of the last dive series, we counted 200 species in these areas -- 198 were new, new species.	Auf einem der letzten Tauchgänge haben wir 200 Arten in diesen Bereichen gezählt . 198 waren neu – neue Arten .
One of the big problems is that for the biologists working at these sites, it's rather difficult to collect these animals.	Eines der größten Probleme der Biologen , die sich mit diesem Lebensraum befassen , ist das Sammeln dieser Tiere .
And they disintegrate on the way up, so the imagery is critical for the science.	Sie lösen sich auf dem Weg nach oben auf , die Bilder sind also sehr wichtig für die Wissenschaft .
Two octopods at about two miles depth.	Zwei Oktopusse in etwa drei Kilometern Tiefe .
This pressure thing really amazes me -- that these animals can exist there at a depth with pressure enough to crush the Titanic like an empty Pepsi can.	Diese Druckverhältnisse finde ich wirklich erstaunlich , dass diese Tiere in einer Tiefe existieren können , bei einem Druck , der groß genug ist , um die Titanic wie eine leere Coladose zu zerquetschen .
What we saw up till now was from the Pacific.	Was wir bisher gesehen haben , war aus dem Pazifik .
And the same thing's going on over here.	Gleichzeitig geschieht hier drüben etwas .
What they're getting at is that -- on the back of this crab -- the foodstuff here is this very strange bacteria that lives on the backs of all these animals.	Was sie hier auf dem Rücken der Krabbe suchen , ist Nahrung , ein sehr seltsames Bakterium , das auf den Rücken all dieser Tiere lebt .
And what these shrimp are trying to do is actually harvest the bacteria from the backs of these animals.	Und diese Garnelen versuchen , die Bakterien von den Rücken all dieser Tiere abzuernten .
And the crabs don't like it at all.	Den Krabben gefällt das gar nicht .
These long filaments that you see on the back of the crab are actually created by the product of that bacteria.	Diese langen Fäden auf dem Rücken der Krabbe bestehen aus Stoffen , die das Bakterium produziert .
So, the bacteria grows hair on the crab.	Die Bakterien sorgen also für Haarwuchs auf der Krabbe .
On the back, you see this again.	Im Hintergrund sieht man das wieder .
The red dot is the laser light of the submarine Alvin to give us an idea about how far away we are from the vents.	Der rote Punkt ist der Laserstrahl des U-Bootes Alvin , der uns zeigt , wie weit wir etwa von den Quellen entfernt sind .
Those are all shrimp.	Das sind alles Garnelen .
You see the hot water over here, here and here, coming out.	Man sieht heißes Wasser hier , hier , hier und hier austreten .
They're clinging to a rock face and actually scraping bacteria off that rock face.	Sie klammern sich an einen Fels und kratzen Bakterien von diesem Fels ab .
Here's a tiny, little vent that's come out of the side of that pillar.	Hier ist eine winzig kleine Quelle an der Seite dieser Säule .
Those pillars get up to several stories.	Diese Säulen sind mehrere Stockwerke hoch .
So here, you've got this valley with this incredible alien landscape of pillars and hot springs and volcanic eruptions and earthquakes, inhabited by these very strange animals that live only on chemical energy coming out of the ground.	Hier ist also ein Tal mit einer unglaublichen , fremdartigen Landschaft aus Säulen , heißen Quellen , Vulkanausbrüchen und Erdbeben , die von diesen sehr merkwürdigen Tieren bewohnt wird , die nur von der chemischen Energie aus dem Meeresboden leben .
They don't need the sun at all.	Sie brauchen die Sonne überhaupt nicht .
You see this white V-shaped mark on the back of the shrimp?	Sehen Sie diese v-förmige Stelle auf dem Rücken dieser Garnele ?
It's actually a light-sensing organ.	Es ist ein lichtempfindliches Organ .
It's how they find the hydrothermal vents.	Damit finden sie die hydrothermalen Quellen .
The vents are emitting a black body radiation -- an IR signature -- and so they're able to find these vents at considerable distances.	Die Quellen geben Wärmestrahlung ab – eine Infrarot-Signatur . So finden sie auch auf recht große Entfernung diese Quellen .
All this stuff is happening along that 40,000-mile long mountain range that we're calling the ribbon of life, because just even today, as we speak, there's life being generated there from volcanic activity.	Das alles spielt sich an dem 13 .000 Kilometer langen Gebirgszug ab , den wir das Lebensband nennen , denn noch heute , in diesem Augenblick , entsteht dort durch vulkanische Aktivität Leben .
This is the first time we've ever tried this any place.	Das ist das erste Mal , dass wir das je irgendwo ausprobiert haben .
We're going to try to show you high definition from the Pacific.	Wir werden versuchen , Ihnen den Pazifik in HD zu zeigen .
We're moving up one of these pillars.	Wir steigen an einer dieser Säulen auf .
This one's several stories tall.	Diese hier ist mehrere Stockwerke hoch .
In it, you'll see that it's a habitat for a lot of different animals.	Sie werden sehen , dass ihr Inneres den Lebensraum für viele verschiedene Tiere bildet .
There's a funny kind of hot plate here, with vent water coming out of it.	Hier ist eine lustige heiße Platte , an der heißes Wasser ausströmt .
So all of these are individual homes for worms.	Das alles sind einzelne Behausungen für Würmer .
Now here's a closer view of that community.	Hier ist man näher an dieser Gemeinschaft dran .
Here's crabs here, worms here.	Hier sind Krabben , hier Würmer .
There are smaller animals crawling around.	Kleinere Tiere kriechen herum .
Here's pagoda structures.	Hier sind Pagodenstrukturen .
I think this is the neatest-looking thing.	Ich finde das hier sieht am tollsten aus .
I just can't get over this -- that you've got these little chimneys sitting here smoking away.	Ich krieg mich nicht wieder ein – wie hier diese kleinen Schornsteine die Gegend vollqualmen .
This stuff is toxic as hell, by the way.	Übrigens ist das Zeug hochgiftig .
You could never get a permit to dump this in the ocean, and it's coming out all from it.	Man würde nie die Erlaubnis bekommen , das im Meer zu verklappen , und es kommt doch alles selbst aus dem Meer .
And animals are thriving -- and we probably came from here.	Und doch gedeihen die Tiere dort – und wir kommen wahrscheinlich ebenfalls von dort .
That's probably where we evolved from.	Wir haben uns vermutlich von dort aus entwickelt .
This bacteria that we've been talking about turns out to be the most simplest form of life found.	Dieses Bakterium , über das wir gesprochen haben , ist die einfachste uns bekannte Lebensform .
There are a number of groups that are proposing that life evolved at these vent sites.	Es gibt eine Reihe von Wissenschaftlern , die die These vertreten , dass das Leben an diesen Quellen entstanden sei .
Although the vent sites are short-lived -- an individual site may last only 10 years or so -- as an ecosystem they've been stable for millions -- well, billions -- of years.	Obwohl diese Quellen nicht lange bestehen – eine einzelne gibt es vielleicht nur zehn Jahre oder so – als Ökosystem sind sie seit Millionen , Milliarden von Jahren stabil .
There's a fish sitting here.	Da sitzt ein Fisch .
Here's a crab with his claw right at the end of that tube worm, waiting for that worm to stick his head out.	Hier ist eine Krabbe mit ihrer Schere genau am Ende dieses Röhrenwurms , die dartauf wartet , dass der Wurm seinen Kopf herausstreckt .
The biologists right now cannot explain why these animals are so active.	Die Biologen können noch nicht erklären , warum diese Tiere so aktiv sind .
The worms are growing inches per week!	Diese Würmer wachsen mehrere Zentimeter in der Woche !
I already said that this site, from a human perspective, is toxic as hell.	Ich sagte schon , dass diese Umgebung aus menschlicher Sicht toxisch wie die Hölle ist .
Not only that, but on top -- the lifeblood -- that plumbing system turns off every year or so.	Nicht nur das . Obendrein stellt sich die Lebensader – das Entwässerungssystem – ungefähr jedes Jahr einmal ab .
Their plumbing system turns off, so the sites have to move.	Das Wassersystem stellt den Betrieb ein , also muss die ganze Umgebung umziehen .
And then there's earthquakes, and then volcanic eruptions, on the order of one every five years, that completely wipes the area out.	Und dann gibt es Erdbeben und die Vulkanausbrüche etwa alle fünf Jahre , die das ganze Gebiet völlig zerstören .
Despite that, these animals grow back in about a year's time.	Nichtsdestotrotz sind die Tiere nach einem Jahr wieder da .
You're talking about biodensities and biodiversity, again, higher than the rainforest that just springs back to life.	Es ist eine Dichte und Vielfalt an Lebensformen , die höher ist als im Regenwald und die einfach so wieder auftaucht .
I'll end up with saying one thing.	Ich möchte zum Schluss noch eines sagen .
There's a story in the sea, in the waters of the sea, in the sediments and the rocks of the sea floor.	Es gibt eine Geschichte im Meer , im Meerwasser , in den Sedimenten und Felsen des Meeresbodens .
It's an incredible story.	Es ist eine unglaubliche Geschichte .
What we see when we look back in time, in those sediments and rocks, is a record of Earth history.	Was wir sehen , wenn wir in die Vergangenheit schauen in diesen Sedimenten und Felsen , ist eine Aufzeichnung der Erdgeschichte .
Everything on this planet -- everything -- works by cycles and rhythms.	Alles auf diesem Planeten – alles – funktioniert in Zyklen und Rhythmen .
What we're learning now, it's almost like a symphony.	Wir finden gerade heraus , dass es fast wie eine Sinfonie ist .
It's just like music -- it really is just like music.	Es ist genau wie Musik – es ist wirklich genau wie Musik .
So, what we've got to learn now is to find out where this planet's going at all these different scales and work with it.	Was wir also lernen müssen , ist herauszufinden , wohin unser Planet treibt , in all seinen verschiedenen Bereichen , und uns darauf einzustellen
Learn to manage it.	Damit umzugehen lernen .
The concept of preservation is futile.	Das Konzept der Bestandsbewahrung ist zwecklos .
Conservation's tougher, but we can probably get there.	Naturschutz ist schwieriger , aber das können wir wahrscheinlich schaffen .
Thank you very much.	Vielen Dank .
Thank you.	Danke .
I'm here today to start a revolution.	Ich bin heute hier , um eine Revolution zu starten .
Now before you get up in arms, or you break into song, or you pick a favorite color, I want to define what I mean by revolution.	Bevor Sie aber Ihr Gewehr justieren , oder anfangen zu singen , oder Ihre Lieblingsfarbe auswählen , will ich Revolution definieren .
By revolution, I mean a drastic and far-reaching change in the way we think and behave -- the way we think and the way we behave.	Revolution meiner Meinung nach ist ein radikaler und durchgreifender Wandel in Denken und Verhalten -- wie wir denken und wie wir uns verhalten .
Now why, Steve, why do we need a revolution?	Aber warum , Steve , brauchen wir eine Revolution ?
We need a revolution because things aren't working; they're just not working.	Wir brauchen eine Revolution , weil die Lage hier so schlecht ist . Sehr schlecht .
And that makes me really sad because I'm sick and tired of things not working.	Und das macht mich sehr traurig , weil ich die Nase voll von der schlechten Lage hier hab .
You know, I'm sick and tired of us not living up to our potential.	Ich hab die Nase voll davon , dass wir unser ganzes Potenzial nicht nutzen .
I'm sick and tired of us being last.	Ich hab die Nase voll , dass wir immer auf dem letzten Platz sind .
And we are last place in so many things -- for example, social factors.	Und wird sind auf dem letzten Platz in vielen Bereichen -- zum Beispiel , die soziale Bedingungen .
We're last place in Europe in innovation.	Wir sind auf dem letzten Platz in Europa im Bereich der Innovation .
There we are right at the end, right at the bottom, last place as a culture that doesn't value innovation.	Wir sind am Ende der Tabelle , Auf dem letzten Platz als die Kultur , die Innovation nicht schätzt .
We're last place in health care, and that's important for a sense of well-being.	Unser Gesundheitssystem ist auf dem letzten Platz , und das ist wichtig für das Wohlbefinden .
And there we are, not just last in the E.U., we're last in Europe, at the very bottom.	Da sind wir auf letztem Platz nicht nur in E .U . , aber auch im ganz Europa - auf dem letzten Platz .
And worst of all, it just came out three weeks ago, many of you have seen it, The Economist.	Das Schlechte ist aber , was das Magazin Economist vor drei Wochen berichtet hat , wie Sie vielleicht gelesen haben ,
We're the saddest place on Earth, relative to GDP per capita -- the saddest place on Earth.	wir sind die traurigste Nation der Welt , relativ zu BIP per Einwohner -- das traurigste Land der Welt .
Where do we rank three weeks ago in another report by the OECD?	Auf welchem Platz sind wir , vor drei Wochen nach einem anderen Bericht von OECD ?
Business: The lowest perception in the E.U.	Das Unternehmenbereich: Die niedrigste Auffassung in E .U .
that entrepreneurs provide benefits to society.	dass Unternehmer der Gesellschaft Vorteile verschaffen .
Why as a result, what happens?	Warum ist das so und was ist geschehen ?
The lowest percentage of entrepreneurs starting businesses.	Der niedrigste Prozentsatz von Unternehmern , die ein Geschäft starten .
And this is despite the fact that everybody knows that small business is the engine of economies.	Und das ist auch so wenn alle wissen , dass kleine Unternehmen den Motor der Wirtschaft sind .
We hire the most people; we create the most taxes.	Wir haben die meisten Angestellten , wir produzieren die meisten Gebühren .
So if our engine's broken, guess what?	Und wenn unser Motor kaputt ist , was sind die Folgen ?
Last in Europe GDP per capita.	Auf dem letzten Platz in Europa bezüglich BIP per Einwohner .
So it's no surprise, guys, that 62 percent of Bulgarians are not optimistic about the future.	Also ist es nicht überraschend , dass nur 62 Prozent der Bulgaren optimistisch für die Zukunft sind .
We're unhappy, we have bad education, and we have the worst businesses.	Wir sind traurig , wir haben schlechte Ausbildung , und wir haben die schwächsten Unternehmen .
And these are facts, guys.	Und das sind die Tatsachen .
This isn't story tale; it's not make-believe.	Das ist kein Märchen , ich phantasiere nicht .
It's not.	Gar nicht .
So I think it should be really, really clear that our system is broken.	So ich glaube es soll sehr klar zu sein , dass unser System kaputt ist .
The way we think, the way we behave, our operating system of behaving is broken.	So wie wir denken und uns verhalten , macht unser Verhaltenssystem kaputt .
We need a drastic change in the way we think and behave to transform Bulgaria for the better, for ourselves, for our friends, for our family and for our future.	Wir brauchen einen durchgreifenden Wandel in Denken und Verhalten um Bulgarien zum etwas Besseren zu verwandeln , für uns und für unsere Freunde , für unsere Familie und unsere Zukunft .
How did this happen?	Wie geschah das ?
I think we're last because -- and this is going to be drastic to some of you -- because we are handicapping ourselves.	Ich glaube wir sind auf dem letzten Platz , weil -- und das wird unangenehm für einige von euch -- weil wir uns selbst behindern .
We're holding ourselves back because we don't value play.	Wir behindern uns selbst , weil wir keine Lust zum Spielen haben .
I said "play," all right.	Ich habe Spielen gesagt .
In case some of you forgot what play is, this is what play looks like.	Falls jemand von Ihnen sich nicht erinnern kann , was Spielen ist , das ist Spielen .
Babies play, kids play, adults play.	Babies spielen , Kinder spielen , Erwachsene spielen .
We don't value play.	Wir schätzen Spielen nicht .
In fact, we devalue play.	Tatsächlich werten wir Spielen ab .
And we devalue it in three areas.	Und wir werten es in drei Bereiche ab .
Let's go back to the same three areas.	Gehen wir zurück zu diesen Bereichen in der Geschichte
Social: 45 years of what?	Sozial: 45 Jahre von was ?
Of communism -- of valuing the society and the state over the individual and squashing, inadvertently, creativity, individual self-expression and innovation.	Von Kommunismus -- von Gesellschaft und Staat mehr hoch achten , als die Einzelperson und quetschen , versehentlich , der Kreativität , dem individuellen Selbstausdruck und der Innovation .
And instead, what do we value?	Und stattdessen , worauf legen wir Wert ?
Because it's shown the way we apply, generate and use knowledge is affected by our social and institutional context, which told us what in communism?	Es ist bekannt , dass die Art und Weise , wie wir Wissen gebrauchen , generieren und nutzen , ist von unserem Sozial- und Istitutionalkontext betroffen , der was uns bei dem Kommunismus gelehrt hat ?
To be serious.	Ernst zu sein .
To be really, really serious.	Wirklich , richtig ernst zu sein .
It did.	Das ist passiert .
Be serious.	Sei ernst .
I can't tell you how many times I've been scolded in the park for letting my kids play on the ground.	Ich kann nicht sagen wie viele Male ich beschimpft geworden bin , weil ich meine Kinder auf dem Boden spielen lasse .
Heaven forbid they play in the dirt, the kal, or even worse, lokvi, water -- that will kill them.	Gott bewahre ,dass ich meine Kinder im Schlamm spielen lasse , oder sogar in Pfützen , Wasser , das wird sie töten .
I have been told by babas and dyados that we shouldn't let our kids play so much because life is serious and we need to train them for the seriousness of life.	Ich bin von Großmüttern und Großvätern beraten worden , dass Kinder nicht so viel spielen sollen , weil das Leben ernst ist , und sie sollen erzogen werden , dass das Leben ernst ist .
We have a serious meme running through.	Wir haben ein durchlaufendes Meme - ernst zu sein .
It's a social gene running through us.	Das ist ein Gen der Gesellschaft .
It's a serious gene.	Das ist ein seriöser Gen .
It's 45 years of it that's created what I call the "baba factor."	Es existiert seit 45 Jahren , und verursachte das Entstehen von dem Großmutterfaktor .
And here's how it works.	Und so funktioniert er .
But then what happens in step three?	Aber was wird im Schritt drei passieren ?
I want to go back to work because I need to further my career or I just want to go have coffees.	Ich will wieder arbeiten , weil ich meine Kariere fördern will oder nur Kaffee trinken will .
I'm going to give bebko to baba.	Ich lasse mein Baby bei der Großmutter .
But we need to remember that baba's been infected by the serious meme for 45 years.	Aber wir müssen uns daran erinnern , dass Großmutter seit 45 Jahren mit dem seriösen Gen infiziert ist .
So what happens?	Was wird geschehen ?
She passes that virus on to baby, and it takes a really, really, really long time -- as the redwood trees -- for that serious meme to get out of our operating system.	Sie gibt dem Baby das Virus weiter , und es geht sehr , sehr , sehr viel Zeit verloren -- wie die Sequoias -- um dieses seriöse Meme von unserem System zu entfernen .
What happens then?	Was wird dann geschehen ?
It goes into education where we have an antiquated education system that has little changed for 100 years, that values rote learning, memorization and standardization, and devalues self-expression, self-exploration, questioning, creativity and play.	Es infiziert unser Ausbildungssystem , das auch veraltet und seit 100 Jahren wenig verändert worden ist , und das Auswendiglernen schätzt , Auswendiglernen und Standardisierung , und wertet Selbstausdruck und Selbsterforschung , Befragung , Kreativität und Spielen ab .
It's a crap system.	Dieses System ist kaputt .
True story: I went looking for a school for my kid.	Eine wahre Geschichte: Ich suchte nach einer Schule für mein Kind .
We went to this prestigious little school and they say they're going to study math 10 times a week and science eight times a week and reading five times a day and all this stuff.	Wir gingen in eine renommierte kleine Schule und da sagte man uns , Kinder werden 10 Mal pro Woche Mathe lernen und Wissenschaft acht Mal pro Woche und lesen fünf Mal pro Woche und so weiter .
And we said, "Well what about play and recess?"	Und wir fragten , "Na gut , aber wie geht es mit Spielen und Schulpausen ?"
And we said, "He's five."	Und wir sagten , "Er ist nur fünf Jahre alt ."
And it's a crime that our education system is so serious because education is serious that we're creating mindless, robotic workers to put bolts in pre-drilled holes.	Und es ist ein Verbrechen , dass unser Ausbildungssystem so seriös ist , weil Ausbildung so seriös ist , dass wir hirnlose Robote produzieren , robotisierte Arbeitskraft die Bolzen in vorgebohrten Löchern drehen .
But I'm sorry, the problems of today are not the problems of the Industrial Revolution.	Aber verzeihen Sie mir , die Probleme heute sind nicht die Probleme von der industriellen Revolution .
We need adaptability, the ability to learn how to be creative and innovative.	Wir brauchen Anpassungsfähigkeit , die Fähigkeit zu lernen , kreativ und innovativ zu sein .
We don't need mechanized workers.	Wir brauchen keine mechanisierte menschliche Arbeitskräft .
But no, now our meme goes into work where we don't value play.	Aber jetzt geht unser Meme arbeiten , wo wir Spielen gar nicht schätzen .
We create robotic workers that we treat like assets, to lever and just throw away.	Wir produzieren robotisierte menschliche Arbeitskraft , die wir wie Aktiva behandeln , die wir stemmen und die wir dann wegwerfen .
What are qualities of a Bulgarian work?	Wie beschreibt man die Arbeit in Bulgarien ?
Autocratic -- do what I say because I'm the chef.	Autokratisch -- Mache was ich sage , weil ich der Boss bin .
I'm the boss and I know better than you.	Ich bin der Boss und ich weiss ich bin besser als dich .
Untrusting -- you're obviously a criminal, so I'm going to install cameras.	Misstrauisch -- Du bist offensichtlich ein Kriminelle , so installiere ich Überwachungskameras .
Controlling -- you're obviously an idiot, so I'm going to make a zillion little processes for you to follow so you don't step out of the box.	Beaufsichtigend -- Du bist offensichtlich ein Idiot , so mache ich für dich viele kleine Prozessen , denen du folgen musst und nicht ausscheren sollst .
So they're restrictive -- don't use your mobile phone, don't use your laptop, don't search the Internet, don't be on I.M.	So sie sind einschränkend -- benutze nicht dein Handy , benutze nicht dein Laptop , surfe nicht in Internet , sei nicht im I .M .
That's somehow unprofessional and bad.	Das ist irgendwie unprofessionell und schlecht .
And at the end of the day, it's unfulfilling because you're controlled, you're restricted, you're not valued and you're not having any fun.	Und am Ende des Tages , gibt es keine Erfüllung , weil du beaufsichtigt , eingeschränkt und nicht bewertet geworden bist , und das macht kein Spaß .
In social, in education and in our business, don't value play.	In der Gesellschaft , in der Ausbildung und in unseren Unternehmen , schätzen wir Spielen nicht .
And that's why we're last, because we don't value play.	Und darum sind wir auf dem letzten Platz , weil wir Spielen nicht schätzen .
It can't be because of play.	Das kann nicht sein , nur wegen des Spielens .
We have the serious meme in us.	Wir haben dieses seröse Meme in uns .
Well I'm going to say no.	Ich werde aber nein sagen .
And I will prove it to you in the next part of the speech -- that play is the catalyst, it is the revolution, that we can use to transform Bulgaria for the better.	Und ich werde das Ihnen beweisen in dem folgenden Teil dieses Vortrags -- dass Spielen der Katalysator , die Revolution ist , und wir können es benutzen , um Bulgarien zum Besseren zu transformieren .
Play: our brains are hardwired for play.	Spielen: Unsere Gehirne sind zum Spielen programmiert .
Evolution has selected, over millions and billions of years, for play in animals and in humans.	Evolution hat es ausgewählt , millione und billione Jahre bevor , für Tiere und Menschen .
And you know what?	Und wissen Sie was ?
Evolution does a really, really good job of deselecting traits that aren't advantageous to us and selecting traits for competitive advantage.	Evolution macht es sehr , sehr gut , im Abwahl von Eigenschaften , die nicht vorteilhaft für uns sind und im Wahl von Eigenschaften , die leistungsfähig und vorteilhaft sind .
Nature isn't stupid, and it selected for play.	Natur ist nicht dumm und hat Spielen ausgewählt .
Maybe you didn't know that.	vielleicht wussten Sie das nicht .
But when they're playing, they're learning the social order and dynamics of things.	Aber wenn sie spielen , lernen sie die Regeln der Gesellschaft und die Dynamik der Dinge .
Rats play, but what you might not have known is that rats that play more have bigger brains and they learn tasks better, skills.	Ratten spielen , aber vielleicht wussten Sie nicht , dass Ratten , die mehr gespielt haben , grössere Gehirne haben , und sie lernen Aufgaben besser , als auch Fähigkeiten .
But what you may not know is that kittens deprived of play are unable to interact socially.	Aber was sie vielleicht nicht wussten , ist dass Kätzchen , die nicht gespielt haben , sozial schwach sind .
They can still hunt, but they can't be social.	Sie können jagen , aber sie haben keine soziale Fähigkeiten .
Bears play.	Bären spielen .
But what you may not know is that bears that play more survive longer.	Aber was Sie vielleicht nicht wussten , ist dass Bären , die mehr gespielt haben , länger leben .
It's not the bears that learn how to fish better.	Nicht die Bären , die besser zu fischen gelernt haben .
It's the ones that play more.	Die Bären , die mehr gespielt haben .
And a final really interesting study -- it's been shown, a correlation between play and brain size.	Und die letzte Untersuchung , die veröffentlicht wurde , zeigt einen Zusammenhang zwischen Spielen und der Grösse des Gehirns .
The more you play, the bigger the brains there are.	Je mehr Sie spielen , desto grösser ist Ihr Gehirn .
Dolphins, pretty big brains, play a lot.	Delphine , die sehr grosse Gehirne haben , spielen viel .
But who do you think with the biggest brains are the biggest players?	Aber wer glauben Sie , ist der grösste Spieler mit dem grössten Gehirn ?
Yours truly: humans.	Ja , genau , die Menschen .
Kids play, we play -- of every nationality, of every race, of every color, of every religion.	Kinder spielen , wir spielen -- Menschen aller Nationalitäten , aller Rassen , aller Farben , aller Religionen ,
It's a universal thing -- we play.	es ist ein universales Ding -- wir spielen .
And it's not just kids, it's adults too.	Und nicht nur die Kinder , Erwachsene auch .
Really cool term: neoteny -- the retention of play and juvenile traits in adults.	Ein sehr guter Begriff: Neotenie -- die Beibehaltung von Spielen und jugendlichen Merkmalen in Erwachsenen .
And who are the biggest neotenists?	Und wer sind die grössten Neoteniesten ?
We do it for fun, or as Olympians, or as professionals.	Wir spielen für Spaß oder als Olympier , oder als professionelle Sportler .
We play musical instruments.	Wir spielen Musikinstrumente .
We dance, we kiss, we sing, we just goof around.	Wir tanzen , küssen , singen , wir bummeln .
We're designed by nature to play from birth to old age.	Wir sind von der Natur zum Spielen programmiert schon als wir geboren waren , bis zum hohen Alter .
We're designed to do that continuously -- to play and play a lot and not stop playing.	Wir sind programmiert das ständig zu machen -- zu spielen und sehr viel zu spielen und nicht aufhören zu spielen .
It is a huge benefit.	Das ist ein grosser Vorteil .
Just like there's benefits to animals, there's benefits to humans.	Genauso wie es Vorteil für die Tiere gibt , gibt es Vorteil auch für die Menschen .
For example, it's been shown to stimulate neural growth in the amygdala, in the area where it controls emotions.	Zum Beispiel , es ist bekannt , dass Spielen das Nervenwachstum in der Amygdala stimuliert , in dem Teil , wo Emotionen kontrolliert werden .
It's been shown to promote pre-frontal cortex development where a lot of cognition is happening.	Es ist bekannt , dass Spielen im präfrontalen Cortex Entwicklung fördert , wo viel Kognition entsteht .
As a result, what happens?	Und was ist das Ergebnis ?
We develop more emotional maturity if we play more.	Wir entwickeln uns mehr emotionale Reife , falls wir mehr spielen .
We develop better decision-making ability if we play more.	Wir entwickeln bessere Entscheidungsfähigkeit , falls wir mehr spielen .
These guys are facts.	Das sind die Tatsachen .
It's not fiction, it's not story tales, it's not make-believe; it's cold, hard science.	Das ist keine Fiktion , kein Märchen , keine Phantasie; es ist unempfindliche , scharfe Wissenschaft .
These are the benefits to play.	Es gibt Vorteile im Spielen .
It is a genetic birthright that we have, like walking or speaking or seeing.	Es ist genetisches Geburtsrecht , das uns gehört , genauso wie Laufen oder Sprechen oder Sehen .
And if we handicap ourselves with play, we handicap ourselves as if we would with any other birthright that we have.	Und falls wir uns selbst mit Spielen behindern , wir behindern uns , als ob wir jedes andere Geburtsrecht , die wir haben , behindern .
We hold ourselves back.	Wir halten uns zurück .
Little exercise just for a second: close your eyes and try to imagine a world without play.	Eine kleine Aufgabe nur für eine Sekunde: schließen Sie Ihre Augen und versuchen Sie sich die Welt ohne Spielen vorzustellen .
Imagine a world without theater, without the arts, without song, without dancing, without soccer, without football, without laughter.	Stellen Sie sich vor , die Welt ohne Theater , ohne Kunst , ohne Lieder , ohne Tanzen , ohne Fußball , ohne Football ohne Lachen .
What does this world look like?	Wie wird diese Welt aussehen ?
It's pretty bleak.	Es ist sehr trostlos .
It's pretty glum.	Es ist sehr bedrückt .
Now imagine your workplace.	Jetzt stellen Sie sich ihren Arbeitsplatz vor .
Or maybe the workplace of your friends -- here we're forward thinking.	Oder vielleicht der Arbeitsplatz von Ihren Freunden -- wir denken vorwärts .
We have this concept that the opposite of play is work.	Wir haben dieses Konzept , dass das Gegenteil von Spielen Arbeit ist .
We even feel guilty if we're seen playing at work.	Wir fühlen uns sogar schuldig , wenn man uns an dem Arbeitsplatz spielen sieht .
But I have news for you: our thinking is backwards.	Aber ich habe eine Nachricht für Sie: Ihr Denken ist rückwärts .
The opposite of play is not work.	Das Gegenteil von Spielen ist nicht Arbeit .
In fact, play improves our work.	Tatsächlich , Spielen verbessert unsere Arbeit .
Just like there's benefits for humans and animals, there's benefits for play at work.	Genauso wie es Vorteile für Menschen und Tiere gibt , gibt es auch Vorteile für die Arbeit .
For example, it stimulates creativity.	Zum Beispiel , es stimuliert Kreativität .
It increases our openness to change.	Es verstärkt unser Freimut zu einer Änderung .
It improves our ability to learn.	Es verstärkt unsere Fähigkeit zu lernen .
It provides a sense of purpose and mastery -- two key motivational things that increase productivity, through play.	Und gibt uns Gefühl von Zweck und Meistersein -- zwei wesentliche motivierende Dinge , die unsere Leistungsfähigkeit verstärkern , durch Spielen .
So before you start thinking of play as just not serious, play doesn't mean frivolous.	So bevor Sie aber Spielen für nicht seriös halten , Spielen bedeutet nicht etwas frivoles .
You know, the professional athlete that loves skiing, he's serious about it, but he loves it.	Wissen Sie , der professionelle Sportler , der Ski mag , ist seriös dafür , aber er hat es gern .
He's having fun, he's in the groove, he's in the flow.	Er findet es lustig , er fühlt sich fantastisch , er macht alles perfekt .
A doctor might be serious, but laughter's still a great medicine.	Ein Doktor kann seriös sein , aber Lachen ist eine großartige Medizin .
Our thinking is backwards.	Unser Denken ist rückwärts .
We shouldn't be feeling guilty.	Wir sollen uns nicht gültig fühlen .
We should be celebrating play.	Wir sollen Spielen feiern .
Quick example from the corporate world.	Ein kurzes Beispiel aus der Firmenwelt .
FedEx, easy motto: people, service, profit.	FedEx , einfaches Motto: Menschen , Dienstleistung , Gewinn .
If you treat your people like people, if you treat them great, they're happier, they're fulfilled, they have a sense of mastery and purpose.	Wenn du deine Angestellte wie Menschen behandelst , großartig behandelst , dann sind sie glücklicher , sie haben Erfüllung , sie haben ein Gefühl von Meistersein und Zweck .
And what do great customers do, great-feeling customers?	Und was werden die glücklichen Kunden machen , die sich sehr glücklich fühlen ?
They buy more of your service and they tell more of their friends, which leads to more profit.	Sie werden mehr von Ihren Dienstleistungen kaufen und sie werden mehr ihren Freunden mitteilen , und das bedeutet einen größeren Gewinn .
People, service, profit.	Menschen , Dienstleistungen , Gewinn .
Play increases productivity, not decreases.	Spielen verstärkt Leistungsfähigkeit , es verschlechtert sie nicht .
One, play is universal.	Erstens - Spielen ist universal .
There's nothing weird about Bulgarians that we can't play, besides the serious meme that we have to kick out.	Es gibt nichts Besonderes in den Bulgaren , das sie vom Spielen abhält , abgesehen von dem seriösen Meme , das wir rausschmeißen sollen .
When I got there, we had zero happy customers.	Als ich in dieser Firma zu arbeiten anfing , gab es keine zufriedene Kunden .
Not one customer would refer us.	Kein Kunde wollte uns weiterempfehlen .
I asked them all.	Ich befragte alle Kunden .
We had marginal profit -- I did.	Wir hatten einen minimalen Gewinn . Ich hatte auch .
We had marginal profits, and we had unhappy stakeholders.	Wir hatten einen minimalen Gewinn , und unzufriedene Stakeholders .
Through some basic change, change like improving transparency, change like promoting self-direction and collaboration, encouraging collaboration, not autocracy, the things like having a results-focus.	Durch einen durchgreifenden Wandel , Wandel , wie zum Beispiel Transparenz , Wandel , wie zum Beispiel Selbststeuerung , und Zusammenarbeit , Zusammenarbeit zu fördern , und nicht Autokratie , diese Dinge sind auf Ergebnisse fokussiert .
I care that your customer and your team is happy and you're organized with that.	Es ist mir wichtig , dass dein Kunde und deine Arbeitsgruppe glücklich sein , und du bist organisiert für das .
Why do I care if you get in at nine o'clock?	Warum soll ich mich kümmern , ob du um neun Uhr kommst ?
Basically promoting fun.	Im Grunde , um Spaß zu fördern .
Through promoting fun and a great environment, we were able to transform Sciant and, in just three short years -- sounds like a long time, but change is slow -- every customer, from zero to every customer referring us, above average profits for the industry and happy stakeholders.	Durch die Förderung von Spaß und lustiger Umgebung , war es uns möglich Sciant zu verwandeln , und das nur nach drei kurzen Jahren -- es klingt wie eine sehr lange Zeit , aber die Veränderung ist langsam -- jeder Kunde , von keinen zu allen Kunden uns weiterzuempfehelen , mehr Gewinn als den durchschnittlichen Gewinn in unserer Industrie , und zufriedene Stakeholders .
And you can say, "Well how do you know they're happy?"	Sie können aber sagen , "Wie kannst du sagen , dass sie zufrieden sind ?"
Well we did win, every year that we entered, one of the rankings for best employer for small business.	Wir haben jedes Jahr gewonnen , und wurden in der Liste der besten Kleinunternehmenarbeitsgeber aufgelistet .
Independent analysis from anonymous employees on their surveys.	Unabhängige Auswertung von anonymen Arbeitnehmern in den Umfragen .
It does, and it can, work in Bulgaria.	So , es funktioniert , und es kann hier in Bulgarien funktionieren .
There's nothing holding us back, except our own mentality about play.	Nichts hält uns zurück , außer unserer eigenen Mentalität über Spielen .
So some steps that we can take -- to finish up -- how to make this revolution through play.	Manche Schritte , die wir machen können -- am Ende -- um diese Revolution durch Spielen schaffen zu können .
First of all, you have to believe me.	Zuerst , Sie sollen mir glauben .
If you don't believe me, well just go home and think about it some more or something.	Falls Sie mir nicht glauben , dann gehen Sie zu Hause und denken Sie noch eine Weile darüber oder über was anderes .
Second of all, if you don't have the feeling of play in you, you need to rediscover play.	Zweitens , falls Sie kein Gefühl zum Spielen haben , dann sollen Sie Spielen neu entdecken .
Whatever it was that as a kid you used to enjoy, that you enjoyed only six months ago, but now that you've got that promotion you can't enjoy, because you feel like you have to be serious, rediscover it.	Was auch immer Ihnen als Kind genossen haben , das Sie auch bevor sechs Monate genossen haben , aber jetzt , dass Sie den Aufstieg geschafft haben , es nicht genießen können , weil Sie fühlen , dass Sie ernst sein sollen , entdecken Sie es neu .
I don't care if it's mountain biking or reading a book or playing a game.	Es ist mir egal , ob es Mountainbike ist , oder ein Buch zu lesen , oder ein Spiel zu Spielen ,
Rediscover that because you're the leaders, the innovation leaders, the thought leaders.	entdecken Sie es neu . Weil Sie die Führungspersönlichkeiten sind , die Innovationsanführer sind , die Master der Ideen sind .
You're the ones that have to go back to the office or talk to your friends and ignite the fire of change in the play revolution.	Sie sind diese , die zurück zu Ihrer Dienststelle gehen sollen , oder mit Ihren Freunden sprechen , und das Feuer zur Änderung im Spielrevolution starten .
You guys have to, and if you're not feeling it, your colleagues, your employees, aren't going to feel it.	Sie sollen das machen , weil falls Sie das nicht fühlen , Ihre Kollegen , Angestellten werden es auch nicht fühlen .
You've got to go back and say, "Hey, I'm going to trust you."	Sie sollen zurück gehen und sagen . "Hören Sie mal , ich werde Ihnen vertrauen ."
Weird concept: I hired you; I should trust you.	Ein seltsames Konzept . Ich habe dich angestellt . Ich soll dir vertrauen .
I'm going to encourage constructive criticism.	Ich werde konstruktive Kritik fördern .
I'm going to let you challenge authority.	Ich werde dich lassen , die Autoritäten herauszufordern .
Because it's by challenging the way things are always done is that we are able to break out of the rut that we're in and create innovative solutions to problems of today.	Weil nur die Herausforderung die einzige Weise ist , die die Dinge immer gemacht werden , die einzige Möglichkeit für uns ist , den alten Trott loszuwerden , und neue kreative Lösungen für die Probleme von heute zu finden .
We're not always right as leaders.	Wir sind nicht immer richtig als Führerperson .
We're going to eradicate fear.	Wir werden die Angst besiegen .
Fear is the enemy of play.	Angst ist der Feind vom Spielen .
And we're going to do things like eliminate restrictions.	Und wir werden Dinge machen , wie zum Beispiel Einschränkungen eliminieren .
You know what, let them use their mobile phone for personal calls -- heaven forbid.	Wissen Sie was , lassen Sie sie ihre Handys benutzen für Privatgespräche -- Gott behüte .
Let them be on the Internet.	Lassen Sie sie im Internet surfen .
Let them be on instant messengers.	Lassen Sie sie im Chat zu sein .
Let them take long lunches.	Lassen Sie sie lange Mittagessen haben .
Lunch is like the recess for work.	Mittagessen ist wie Urlaub von der Arbeit .
It's when you go out in the world and you recharge your brain, you meet your friends, you have a beer, you have some food, you talk, you get some synergy of ideas that maybe you wouldn't have had before.	Es ist die Zeit , wenn Sie draußen in die Welt gehen , und Ihr Gehirn aufladen , Freunde treffen , ein Bier trinken , etwas essen , sprechen , und dann bekommen Sie Synergie von Ideen , Die Sie niemals bevor hatten .
So in summary, we need a drastic change in the way we think and behave, but we don't need a workers' revolution.	So in Zusammenfassung , wir brauchen einen durchgreifenden Wandel in unserem Denken und Verhalten , aber wir brauchen keine Revolution der Angestellten .
We don't need a workers' revolution.	Wir brauchen keine Revolution der Angestellten .
What we need is a players' uprising.	Was wir brauchen ist einen Aufstand der Spielern .
What we need is a players' uprising.	Was wir brauchen ist einen Aufstand der Spielern .
What we need is a players' uprising.	Was wir brauchen ist einen Aufstand der Spielern .
Seriously, we need to band together.	Ganz im Ernst , wir sollen uns zusammenschließen .
Today is the start of the uprising.	Heute soll der Anfang von dem Aufstand stattfinden .
But what you need to do is fan the flames of the revolution.	Aber was Sie tun sollen , ist das Feuer der Revolution entfachen .
You need to go and share your ideas and your success stories of what worked about reinvigorating our lives, our schools, and our work with play; about how play promotes a sense of promise and self-fulfillment; of how play promotes innovation and productivity, and, ultimately, how play creates meaning.	Sie sollen Ihre Ideen und Erfolgsgeschichten teilen , was funktioniert hat und unser Leben , unsere Schulen , und unsere Arbeit durch Spielen wiederbelebt hat; Wie Spielen ein Gefühl von Versprechen und Selbstverwirklichung fördert; Wie Spielen Innovation und Produktivität fördert; und schließlich , wie Spielen einen Sinn schafft .
Thank you.	Danke schön .
Radical openness is still a distant future in the field of school education.	In der Schulbildung sind wir von einer kompromisslosen Offenheit noch weit entfernt .
We have such a hard time figuring out that learning is not a place but an activity.	Wir tun uns schwer genug damit , Lernen als Aktivität und nicht als Ort zu erkennen .
But I want to tell you the story of PISA, OECD's test to measure the knowledge and skills of 15-year-olds around the world, and it's really a story of how international comparisons have globalized the field of education that we usually treat Look at how the world looked in the 1960s, in terms of the proportion of people who had completed high school.	Aber lassen Sie uns jetzt über PISA reden , die weltweite Studie der OECD zur Evaluierung von Wissen und Fähigkeiten . Denn durch PISA wurde die Schulbildung , die in der Regel eine nationale Angelegenheit ist , Sehen wir uns mal die Situation in den 60ern an , in Bezug auf den Anteil der Bevölkerung mit Abitur .
You can see the United States ahead of everyone else, and much of the economic success of the United States draws on its long-standing advantage as the first mover in education.	Sie sehen , die USA sind an erster Stelle , und ein Großteil des ökonomischen Erfolgs der USA ist mit diesem traditionellen Vorteil als Vorreiter in der Schulbildung verknüpft .
But in the 1970s, some countries caught up.	Aber in den 70ern holten einige Länder auf .
In the 1980s, the global expansion of the talent pool continued.	In den 80ern schritt die globale Ausweitung des Talent-Pools fort .
And the world didn't stop in the 1990s.	Die Welt endete nicht in den 90ern .
In the '90s, it was 13th, and not because standards had fallen, but because they had risen so much faster elsewhere.	In den 90er Jahren an 13 . Stelle , und das nicht wegen eines sinkenden Niveaus , sondern weil das Niveau anderswo schneller angestiegen ist .
Korea shows you what's possible in education.	Anhand von Korea wird deutlich , was möglich ist .
Two generations ago, Korea had the standard of living of Afghanistan today, and was one of the lowest education performers.	Vor zwei Generationen war der Lebensstandard in Korea auf dem des heutigen Afghanistans und es schnitt bei der Schulbildung mit am Schlechtesten ab .
Today, every young Korean finishes high school.	Heute hat jeder junge Mensch in Korea Abitur .
So this tells us that, in a global economy, it is no longer national improvement that's the benchmark for success, but the best performing education systems internationally.	In einer globalen Wirtschaft ist nicht mehr der nationale Fortschritt der Maßstab , sondern die leistungsstärksten Bildungssysteme auf internationaler Ebene .
The trouble is that measuring how much time people spend in school or what degree they have got is not always a good way of seeing what they can actually do.	Das Problem ist , dass eine Angabe über die Dauer der Schulzeit oder über den Abschluss nicht immer darlegt , was diese Menschen tatsächlich leisten können .
Look at the toxic mix of unemployed graduates on our streets, while employers say they cannot find the people with the skills they need.	Wir haben jede Menge arbeitsloser Studienabgänger auf den Straßen und gleichzeitig klagen Arbeitgeber über einen Fachkräftemangel .
And that tells you that better degrees don't automatically translate into better skills and better jobs and better lives.	Dies besagt , dass ein besserer Abschluss nicht automatisch mit besseren Fähigkeiten , einem besseren Arbeitsplatz und einem besseren Leben einhergeht .
So with PISA, we try to change this by measuring the knowledge and skills of people directly.	Mit der PISA-Studie versuchen wir dies nun zu ändern , indem wir das Wissen und die Fähigkeiten der jungen Leute direkt messen .
And we took a very special angle to this.	Wir tun dies aus einem speziellen Blickwinkel .
We were less interested in whether students can simply reproduce what they have learned in school, but we wanted to test whether they can extrapolate from what they know and apply their knowledge in novel situations.	Unser Interesse galt nicht dem Wiedergeben von Erlerntem seitens der Schüler . Wir wollten wissen , ob sie das Erlernte abstrahieren und ihr Wissen auf neue Situationen anwenden können .
Now, some people have criticized us for this.	Wir sahen uns dabei einiger Kritik gegenüber .
They say, you know, such a way of measuring outcomes is terribly unfair to people, because we test students with problems they haven't seen before.	Nämlich dass diese Art von Ergebnismessung sehr unfair sei , weil wir die Schüler vor Probleme stellen , auf die sie noch nie gestoßen waren .
But if you take that logic, you know, you should consider life unfair, because the test of truth in life is not whether we can remember what we learned in school, but whether we are prepared for change, whether we are prepared for jobs that haven't been created, to use technologies that haven't been invented, to solve problems we just can't anticipate today.	Aber nach dieser Logik ist das ganze Leben unfair , denn die wahre Prüfung im Leben besteht nicht darin , ob wir uns an den Schulstoff erinnern , sondern ob wir bereit für Veränderungen sind , ob wir bereit sind für Jobs , die noch nicht existieren , bereit , Technologien zu verwenden , die noch nicht erfunden sind und Probleme zu lösen , die wir heute noch nicht ahnen können .
And once hotly contested, our way of measuring outcomes has actually quickly become the standard.	Und unser einst umstrittenes Verfahren zur Ergebnismessung wurde rasch zum Standard .
In our latest assessment in 2009, we measured 74 school systems that together cover 87 percent of the economy.	Bei unserer letzten Auswertung 2009 erfassten wir 74 Schulsysteme , die zusammen 87 % der Wirtschaft ausmachen .
This chart shows you the performance of countries.	Diese Tabelle zeigt die Leistung nach Ländern .
In red, sort of below OECD average.	Rot bedeutet unter dem OECD-Durchschnitt ,
Yellow is so-so, and in green are the countries doing really well.	gelb bedeutet mittelmäßig und die Länder in grün sind am stärksten .
You can see Shanghai, Korea, Singapore in Asia; Finland in Europe; Canada in North America doing really well.	Wir haben hier Shanghai , Korea und Singapur in Asien; Finnland in Europa; und Kanada in Nordamerika .
three and a half school years between 15-year-olds in Shanghai and 15-year-olds in Chile, and the gap grows to seven school years when you include the countries with really poor performance.	15-Jährigen in Shanghai und 15-Jährigen in Chile beträgt fast 3 ,5 Schuljahre . Diese Lücke wächst auf 7 Jahre an , wenn wir die Länder einschließen , die wirklich schlecht abschneiden .
There's a world of difference in the way in which young people are prepared for today's economy.	Junge Leute werden sehr unterschiedlich auf die heutige Wirtschaft vorbereitet .
But I want to introduce a second important dimension into this picture.	Aber ich möchte in diesem Kontext eine zweite , wichtige Dimension einführen .
Educators like to talk about equity.	Pädagogen sprechen gerne über Gleichheit .
With PISA, we wanted to measure how they actually deliver equity, in terms of ensuring that people from different social backgrounds have equal chances.	Mit der PISA-Studie wollten wir erfassen , wie diese Gleichheit , die dafür sorgt , dass Schüler aus verschiedenem Umfeld die gleichen Chancen haben , in der Realität aussieht .
And we see that in some countries, the impact of social background on learning outcomes is very, very strong.	Und wir sehen , dass der Einfluss des Umfelds auf die Lernleistung in manchen Ländern sehr , sehr stark ist .
Opportunities are unequally distributed.	Chancen sind ungleich verteilt .
A lot of potential of young children is wasted.	Viel Potential von Kindern wird verschwendet .
We see in other countries that it matters much less into which social context you're born.	In anderen Ländern kommt es viel weniger auf das soziale Umfeld der Kinder an .
We all want to be there, in the upper right quadrant, where performance is strong and learning opportunities are equally distributed.	Wir alle wollen hier sein , im Quadranten rechts oben , in dem die Leistung stark und Lernchancen gleich verteilt sind .
Nobody, and no country, can afford to be there, where performance is poor and there are large social disparities.	Niemand und kein Land kann es sich leisten , dort zu sein , wo die Leistung schlecht ist und große soziale Disparitäten herrschen .
And then we can debate, you know, is it better to be there, where performance is strong at the price of large disparities?	Dann steht die Debatte an , ob es besser ist , dort zu sein , wo die Leistung stark ist und dafür große Disparitäten in Kauf zu nehmen ?
Or do we want to focus on equity and accept mediocrity?	Oder einigen wir uns auf Gleichheit und akzeptieren Mittelmäßigkeit ?
But actually, if you look at how countries come out on this picture, you see there are a lot of countries that actually are combining excellence with equity.	Wenn wir die Leistung der Länder diesbezüglich betrachten , sehen wir viele Länder , die hervorragende Leistungen mit Gleichheit verbinden .
In fact, one of the most important lessons from this comparison is that you don't have to compromise equity to achieve excellence.	In der Tat ist eine der wichtigsten Lektionen , aus diesem Vergleich , dass Gleichheit nicht zugunsten hervorragender Leistungen geopfert werden muss .
These countries have moved on from providing excellence for just some to providing excellence for all, a very important lesson.	Diese Länder haben den Schritt von der Leistung für wenige zur Leistung für alle gemacht , eine sehr wichtige Lektion .
And that also challenges the paradigms of many school systems that believe they are mainly there to sort people.	Diese Lektion fordert das Denken vieler Schulsysteme heraus , die hauptsächlich Schüler aussortieren .
And ever since those results came out, policymakers, educators, researchers from around the world what's behind the success of those systems.	Seit Veröffentlichung dieser Ergebnisse versuchen nun Entscheidungsträger , Pädagogen und Forscher weltweit was hinter dem Erfolg dieser Systeme steckt .
But let's step back for a moment and focus on the countries that actually started PISA, and I'm giving them a colored bubble now.	Gehen wir einen Schritt zurück und konzentrieren uns auf die Länder , in denen PISA anfing – sie sind jetzt mit einem bunten Kreis markiert .
And I'm making the size of the bubble proportional to the amount of money that countries spent on students.	Die Größe des Kreises gleiche ich jetzt proportional an die Ausgaben der jeweiligen Länder für Schüler an .
If money would tell you everything about the quality of learning outcomes, you would find all the large bubbles at the top, no?	Wäre Geld entscheidend bei der Qualität der Lernergebnisse , müssten die großen Kreise ganz oben sein .
But that's not what you see.	Aber so ist es nicht .
Spending per student only explains about, well, less than 20 percent of the performance variation among countries, and Luxembourg, for example, the most expensive system, doesn't do particularly well.	Die Ausgaben pro Schüler sind nur zu unter 20 % für die Leistungsschwankungen zwischen den Ländern verantwortlich . Luxemburg etwa , das teuerste System , schneidet nicht besonders gut ab .
What you see is that two countries with similar spending achieve very different results.	Wir sehen , dass zwei Länder mit ähnlichen Ausgaben sehr unterschiedliche Ergebnisse erzielen .
You also see -- and I think that's one of the most encouraging findings -- that we no longer live in a world that is neatly divided between rich and well-educated countries, and poor and badly-educated ones, a very, very important lesson.	Wir sehen auch – und das ist eines der ermutigstenden Ergebnisse – , dass unsere Welt nicht mehr aufgeteilt ist in reiche Länder mit hohem Bildungsniveau und arme Länder mit niedrigem Bildungsniveau . Das ist ein enorm wichtiges Ergebnis .
Let's look at this in greater detail.	Nun einmal mehr im Detail .
The red dot shows you spending per student relative to a country's wealth.	Der rote Punkt gibt die prozentualen Ausgaben eines Landes pro Schüler an .
One way you can spend money is by paying teachers well, and you can see Korea investing a lot in attracting the best people into the teaching profession.	Geld kann für Lehrergehälter ausgegeben werden Korea etwa investiert viel , um die Lehrerlaufbahn attraktiv zu machen .
And Korea also invests into long school days, which drives up costs further.	Ein langer Schultag lässt die Kosten weiter steigen .
Last but not least, Koreans want their teachers not only to teach but also to develop.	Und zudem sollen die Lehrer nicht nur unterrichten , sondern sich auch fortbilden .
They invest in professional development and collaboration and many other things.	Korea investiert viel in die berufliche Weiterentwicklung , Zusammenarbeit und mehr .
All that costs money.	All dies kostet Geld .
How can Korea afford all of this?	Wie kann sich Korea dies alles leisten ?
The answer is, students in Korea learn in large classes.	Koreas Schüler sitzen in großen Klassen .
This is the blue bar which is driving costs down.	Das senkt die Kosten , sichtbar am blauen Balken .
You go to the next country on the list, Luxembourg, and you can see the red dot is exactly where it is for Korea, so Luxembourg spends the same per student as Korea does.	Beim nächsten Land , Luxemburg , ist der rote Punkt an derselben Stelle wie bei Korea , was bedeutet , dass Luxemburg die gleichen Ausgaben pro Schüler hat wie Korea .
But, you know, parents and teachers and policymakers in Luxembourg all like small classes.	Aber Eltern , Lehrer und Entscheidungsträger in Luxemburg plädieren für kleine Klassen .
You know, it's very pleasant to walk into a small class.	Es ist ja ganz angenehm , in eine kleine Klasse zu kommen .
So they have invested all their money into there, and the blue bar, class size, is driving costs up.	Das ganze Geld wurde also dafür verwendet und der blaue Balken , die Klassengröße , lässt die Kosten steigen .
But even Luxembourg can spend its money only once, and the price for this is that teachers are not paid particularly well.	Aber selbst Luxemburg kann das Geld nur einmal ausgeben und der Preis dafür ist , dass Lehrer nicht besonders gut bezahlt sind .
Students don't have long hours of learning.	Die Schüler müssen nicht stundenlang lernen .
And basically, teachers have little time to do anything else than teaching.	Wodurch Lehrer sehr viel unterrichten müssen .
So you can see two countries spent their money very differently, and actually how they spent their money matters a lot more than how much they invest in education.	Diese zwei Länder geben ihr Geld also ganz unterschiedlich aus . Wofür sie ihr Geld ausgeben , ist weitaus entscheidender , als die Menge des für Bildung ausgegebenen Geldes .
Let's go back to the year 2000.	Zurück ins Jahr 2000 .
Remember, that was the year before the iPod was invented.	Das war ein Jahr vor Erfindung des iPod .
This is how the world looked then in terms of PISA performance.	So sahen die PISA-Ergebnisse damals weltweit aus .
The first thing you can see is that the bubbles were a lot smaller, no?	Zunächst sehen Sie , dass die Kreise viel kleiner waren , nicht wahr ?
We spent a lot less on education, about 35 percent less on education.	Wir haben viel weniger für Bildung ausgegeben , etwa 35 % weniger .
So you ask yourself, if education has become so much more expensive, has it become so much better?	Wenn Bildung so viel teurer geworden ist , ist sie auch besser geworden ?
And the bitter truth really is that, you know, not in many countries.	Die bittere Wahrheit ist , dass sie nur in wenigen Ländern besser geworden ist .
But there are some countries which have seen impressive improvements.	Aber in einigen Ländern haben wir massive Verbesserungen gesehen .
Germany, my own country, in the year 2000, featured in the lower quadrant, below average performance, large social disparities.	Deutschland etwa , mein Heimatland , befand sich im Jahr 2000 im unteren Quadranten , unterdurchschnittliche Leistung , große soziale Ungleichheiten .
And remember, Germany, we used to be one of those countries that comes out very well when you just count people who have degrees.	Und erinnern Sie sich , dass Deutschland sehr gut abschneidet , wenn wir nur die Bewohner mit Universitätsabschluss zählen .
Very disappointing results.	Sehr enttäuschende Ergebnisse .
People were stunned by the results.	Niemand mochte es recht glauben .
And for the very first time, the public debate in Germany was dominated for months by education, not tax, not other kinds of issues, but education was the center of the public debate.	Und zum ersten Mal war die öffentliche Debatte in Deutschland monatelang vom Thema Bildung geprägt . Nicht Steuern oder andere Probleme , sondern die Bildung stand im Fokus der öffentlichen Diskussion .
And then policymakers began to respond to this.	Und Entscheidungsträger haben darauf reagiert .
The federal government dramatically raised its investment in education.	Die Bundesregierung erhöhte die Bildungsausgaben drastisch .
A lot was done to increase the life chances of students with an immigrant background or from social disadvantage.	Und es wurde viel unternommen , um Schülern mit Migrationshintergrund oder aus sozial schwachen Familien die gleichen Chancen zu geben .
And what's really interesting is that this wasn't just about optimizing existing policies, but data transformed some of the beliefs and paradigms underlying German education.	Und das Interessante ist , dass es nicht um die Optimierung der bestehenden Politik ging , sondern dass diese Daten grundlegende Annahmen und Überzeugungen des deutschen Bildungssystems veränderten .
For example, traditionally, the education of the very young children where women were seen as neglecting their family responsibilities when they sent their children to kindergarten.	Traditionell war bis dahin die Kleinkindererziehung Frauen galten schnell als Rabenmütter , wenn sie ihre Kinder in den Kindergarten schickten .
PISA has transformed that debate, and pushed early childhood education right at the center of public policy in Germany.	PISA hat diese Debatte transformiert und die Früherziehung ins Zentrum der öffentlichen Politik in Deutschland gerückt .
Or traditionally, the German education divides children at the age of 10, very young children, between those deemed to pursue careers of knowledge workers and those who would end up working for the knowledge workers, and that mainly along socioeconomic lines, and that paradigm is being challenged now too.	Ein anderes Beispiel: Das deutsche System teilt Kinder bereits mit 10 Jahren in zwei Gruppen auf: die einen werden zu Wissensarbeitern , die anderen werden für die Wissensarbeiter arbeiten . Und diese Aufteilung erfolgt entlang des sozialwirtschaftlichen Grabens . Auch dieses Denkmuster wird jetzt herausgefordert .
A lot of change.	Viele Veränderungen .
And the good news is, nine years later, you can see improvements in quality and equity.	Und die gute Nachricht ist , dass sich 9 Jahre später Verbesserungen bei der Qualität und Gleichheit zeigen .
People have taken up the challenge, done something about it.	Man hat die Herausforderung angenommen und etwas unternommen .
Or take Korea, at the other end of the spectrum.	Oder nehmen wir Korea , am anderen Ende des Spektrums .
In the year 2000, Korea did already very well, but the Koreans were concerned that only a small share of their students achieved the really high levels of excellence.	Das Land schnitt im Jahr 2000 sehr gut ab , aber man war besorgt , dass nur ein kleiner Teil der Schüler wirklich gute Ergebnisse erzielte .
They took up the challenge, and Korea was able to double the proportion of students achieving excellence in one decade in the field of reading.	Man nahm die Herausforderung an und heute erzielen zweimal so viele Schüler Bestergebnisse beim Lesen – innerhalb eines Jahrzehnts .
Well, if you only focus on your brightest students, you know what happens is disparities grow, and you can see this bubble moving slightly to the other direction, but still, an impressive improvement.	Wenn man sich nur auf die schlausten Schüler konzentriert , teilt sich der Graben weiter . Der Kreis bewegt sich ganz leicht in die andere Richtung , aber die Verbesserung ist dennoch enorm .
A major overhaul of Poland's education helped to dramatically reduce between variability among schools, turn around many of the lowest-performing schools, and raise performance by over half a school year.	Eine grundlegende Überholung des Schulsystems hat in Polen zu einer Anpassung der Qualitäten zwischen den Schulen geführt , viele der am schlechtesten abgeschnittenen Schulen verbessert und und die Leistungen pro Schuljahr um über 50 % angehoben .
And you can see other countries as well.	Auch andere Länder haben dies geschafft .
Portugal was able to consolidate its fragmented school system, raise quality and improve equity, and so did Hungary.	In Portugal wurde das fragmentierte Schulsystem vereinheitlicht und die Qualität und Gleichheit verbessert . Genau wie in Ungarn .
So what you can actually see, there's been a lot of change.	Sie sehen also , dass viel passiert ist .
And even those people who complain and say that the relative standing of countries on something like PISA is just an artifact of culture, of economic factors, of social issues, of homogeneity of societies, and so on, these people must now concede that education improvement is possible.	Auch die Kritiker , die behaupten , die relative Länderposition in einer Studie wie PISA sei nur ein Produkt der Kultur , wirtschaftlicher Faktoren , sozialer Probleme , der gesellschaftlichen Homogenität usw . müssen zugeben , dass Verbesserungen im Bildungsbereich möglich sind .
You know, Poland hasn't changed its culture.	Polen hat bekanntlich nicht seine Kultur geändert .
And all that raises, of course, the question: What can we learn from those countries in the green quadrant who have achieved high levels of equity, high levels of performance, and raised outcomes?	Daraus ergibt sich nun die Frage: Was können wir von den Ländern im grünen Quadranten mit einer hohen Gleichheitsrate , sehr guten Ergebnissen und verbesserter Leistung lernen ?
And, of course, the question is, can what works in one context provide a model elsewhere?	Und natürlich: Kann ein Erfolgsrezept auf alle angewandt werden ?
Of course, you can't copy and paste education systems wholesale, but these comparisons have identified a range of factors that high-performing systems share.	Natürlich kann man nicht einfach das ganze Bildungssystem kopieren , aber über diese Vergleiche wurden Faktoren identifziert , die allen guten Systemen zugrunde liegen .
Everybody agrees that education is important.	Wir allen stimmen zu , dass Bildung wichtig ist .
Everybody says that.	Jeder sagt das .
But the test of truth is, how do you weigh that priority against other priorities?	Aber die Feuertaufe ist: Wie wichtig ist Bildung im Vergleich zu anderen Prioritäten ?
How do countries pay their teachers relative to other highly skilled workers?	Wie sollen Länder ihre Lehrer im Vergleich zu anderen hochqualifizierten Arbeitern bezahlen ?
Would you want your child to become a teacher rather than a lawyer?	Würden Sie wollen , dass Ihr Kind lieber Lehrer oder Anwalt wird ?
How do the media talk about schools and teachers?	Wie werden Schulen und Lehrer in den Medien dargestellt ?
Those are the critical questions, and what we have learned from PISA is that, in high-performing education systems, the leaders have convinced their citizens to make choices that value education, their future, more than consumption today.	Dies sind die entscheidenden Fragen . Und von PISA haben wir gelernt , dass in guten Bildungssystemen die Bürger überzeugt wurden , Entscheidungen für ihre Bildung und Zukunft zu treffen und nicht kurzfristig zu denken .
Those things really exist.	Ja , diese Länder existieren .
But placing a high value on education is just part of the picture.	Der Bildung hohen Wert beizumessen , ist nur ein Teil der Geschichte .
The other part is the belief that all children are capable of success.	Der andere ist die Überzeugung , dass alle Kinder erfolgreich sein können .
You have some countries where students are segregated early in their ages.	In manchen Ländern werden Schüler schon früh getrennt .
You know, students are divided up, reflecting the belief that only some children can achieve world-class standards.	Dies spiegelt die Überzeugung wider , dass nur manche Kinder eine weltklasse Leistung erbringen können .
But usually that is linked to very strong social disparities.	Dies geht jedoch in der Regel mit starken sozialen Unterschieden einher .
If you go to Japan in Asia, or Finland in Europe, parents and teachers in those countries expect every student to succeed, and you can see that actually mirrored in student behavior.	In Ländern wie Japan oder Finnland erwarten alle Eltern und Lehrer , dass jeder Schüler erfolgreich ist , und dies spiegelt sich im Verhalten der Schüler wider .
When we asked students what counts for success in mathematics, students in North America would typically tell us, you know, it's all about talent.	Wenn wir Schüler in Nordamerika fragen , was für den Erfolg in Mathematik entscheidend ist , antworten sie in der Regel , dass alles von der Begabung abhängt .
If I'm not born as a genius in math, I'd better study something else.	Wenn ich nicht als Mathegenie geboren wurde , lerne ich besser was anderes .
Nine out of 10 Japanese students say that it depends on my own investment, on my own effort, and that tells you a lot about the system that is around them.	9 von 10 japanischen Schülern antworten , dass es von ihrem Aufwand und ihren Bemühungen abhängt . Das spricht Bände über das jeweilige System .
In the past, different students were taught in similar ways.	In der Vergangenheit wurden unterschiedliche Schüler gleich unterrichtet .
High performers on PISA embrace diversity with differentiated pedagogical practices.	Länder mit guten PISA-Ergebnissen nehmen die Unterschiede über differenzierte pädagogische Vorangehensweisen an .
They realize that ordinary students have extraordinary talents, and they personalize learning opportunities.	Sie erkennen , dass gewöhnliche Schüler außergewöhnliche Begabungen haben , und gestalten Lernmöglichkeiten individuell .
High-performing systems also share clear and ambitious standards across the entire spectrum.	Gute Bildungssysteme teilen die gleichen klaren und ehrgeizigen Standards im gesamten Spektrum .
Every student knows what matters.	Jeder Schüler weiß , worauf es ankommt .
Every student knows what's required to be successful.	Jeder Schüler weiß , was für den Erfolg nötig ist .
And nowhere does the quality of an education system exceed the quality of its teachers.	Und die Qualität des Schulsystems ist nirgendwo besser als die Qualität der Lehrer .
High-performing systems are very careful in how they recruit and select their teachers and how they train them.	Gute Schulsysteme wählen ihre Lehrer sehr sorgsam aus und bilden sie gezielt weiter .
They watch how they improve the performances of teachers in difficulties who are struggling, and how they structure teacher pay.	Die Leistungen von Lehrern , die vielleicht Probleme haben , werden gezielt verbessert . Das Gehalt eines jeden Lehrers ist strukturiert .
They provide an environment also in which teachers work together to frame good practice.	Ein Umfeld wird geschaffen für die Zusammenarbeit unter Lehrern , um gute Methoden zu fördern .
And they provide intelligent pathways for teachers to grow in their careers.	Und es gibt individuelle Karrieremöglichkeiten für Lehrer .
In bureaucratic school systems, teachers are often left alone in classrooms with a lot of prescription on what they should be teaching.	In bürokratischen Schulsystemen werden die Lehrer in den Klassen alleine gelassen und haben sich an viele Unterrichtsvorgaben zu halten .
High-performing systems are very clear what good performance is.	In den guten Systemen herrscht eine klare Vorstellung von guter Leistung .
They set very ambitious standards, but then they enable their teachers to figure out, what do I need to teach to my students today?	Das Niveau ist sehr hoch , aber die Lehrer können selbst herausfinden , was sie ihren Schülern jeweils beibringen müssen .
The past was about delivered wisdom in education.	In der Vergangenheit ging es um die Weitergabe von Wissen .
Now the challenge is to enable user-generated wisdom.	Jetzt sollen die Schüler aus eigenem Antrieb Wissen erlangen .
High performers have moved on from professional or from administrative forms of accountability and control -- to professional forms of work organization.	In guten Schulsystemem kommt es nicht mehr auf professionelle oder administrative Verantwortung und Kontrolle an , professionelle Art der Arbeitsorganisation .
They enable their teachers to make innovations in pedagogy.	So können Lehrer Innovationen in der Pädagogik vorantreiben .
They provide them with the kind of development they need to develop stronger pedagogical practices.	Sie haben somit die richtigen Voraussetzungen , um stärkere pädagogische Methoden zu entwickeln .
The goal of the past was standardization and compliance.	Früher ging es um Standardisierung und Einhaltung von Vorschriften .
High-performing systems have made teachers and school principals inventive.	In guten Schulsystemen sind Lehrer und Rektoren erfinderisch geworden .
In the past, the policy focus was on outcomes, on provision.	Früher ging es um Ergebnisse , um die eigene Versorgung .
The high-performing systems have helped teachers and school principals to look outwards to the next teacher, the next school around their lives.	In guten Schulsystemen können sich Lehrer und Rektoren nach neuen Lehrern und anderen Schulen umsehen .
And the most impressive outcomes of world-class systems is that they achieve high performance across the entire system.	Das beeindruckendste Ergebnis von erstklassigen Systemen ist , dass diese hohe Leistung für das gesamte System gilt .
You've seen Finland doing so well on PISA, but what makes Finland so impressive is that only five percent of the performance variation amongst students lies between schools.	Finnland schnitt bei der PISA-Studie sehr gut ab . Aber das Beeindruckendste an Finnland ist , dass nur 5 % der Leistungsunterschiede zwischen Schülern auf verschiedene Schulen zurückzuführen sind .
Every school succeeds.	Jede Schule ist erfolgreich .
This is where success is systemic.	Hier ist der Erfolg im System inbegriffen .
And how do they do that?	Wie wird das erreicht ?
They invest resources where they can make the most difference.	Ressourcen gelangen dorthin , wo sie die größte Wirkung haben .
They attract the strongest principals into the toughest schools, and the most talented teachers into the most challenging classroom.	Die besten Rektoren werden für die schwächsten Schulen gewonnen und die begabtesten Lehrer stehen in den herausforderndsten Klassen .
Last but not least, those countries align policies across all areas of public policy.	Und diese Länder gleichen ihre Vorgaben in allen Bereichen der öffentlichen Politik an .
They make them coherent over sustained periods of time, and they ensure that what they do is consistently implemented.	Sie sind über anhaltende Zeiträume hinweg kohärent und werden konsequent umgesetzt .
Now, knowing what successful systems are doing doesn't yet tell us how to improve.	Obwohl wir die Grundlagen erfolgreicher Systeme kennen , wissen wir noch nicht , wie wir uns verbessern .
That's also clear, and that's where some of the limits of international comparisons of PISA are.	Das ist klar und darin liegen einige der Grenzen des internationalen PISA-Vergleiches .
That's where other forms of research need to kick in, and that's also why PISA doesn't venture into telling countries what they should be doing.	Hier sind neue Forschungsansätze gefragt und dies ist der Grund , warum PISA den Ländern keine Vorschriften macht .
But its strength lies in telling them what everybody else has been doing.	Die Stärke liegt in der Mitteilung darüber , was andere Länder unternommen haben .
And the example of PISA shows that data can be more powerful than administrative control of financial subsidy through which we usually run education systems.	Und am Beispiel von PISA wird deutlich , dass Daten einflussreicher sein können als die administrative Kontrolle der Gelder , wie sie für Bildungssysteme in der Regel entscheidend sind .
You know, some people argue that changing educational administration is like moving graveyards.	Manche Leute behaupten , dass die Veränderung der Bildungsverwaltung dem Verlegen eines Friedhofs ähnelt .
You just can't rely on the people out there to help you with this.	Man kann dabei nicht auf die Leute da draußen zählen .
But PISA has shown what's possible in education.	Aber PISA zeigt die Möglichkeiten in der Bildung auf .
It has helped countries to see that improvement is possible.	Länder sehen nun , dass Verbesserungen möglich sind .
It has taken away excuses from those who are complacent.	Selbstgefällige Systeme haben keine Ausreden mehr .
And it has helped countries to set meaningful targets in terms of measurable goals achieved by the world's leaders.	Und Länder können sinnvolle Ziele setzen und sich an den messbaren Zielen der besten Systeme weltweit orientieren .
If we can help every child, every teacher, every school, every principal, every parent see what improvement is possible, that only the sky is the limit to education improvement, we have laid the foundations for better policies and better lives.	Wenn wir jedem Kind , Lehrer , Rektor , Elternteil und jeder Schule zeigen können , dass Verbesserungen möglich sind , dass der Verbesserung in der Bildung keine Grenzen gesetzt sind , haben wir den Grundstein für bessere Vorgaben und ein besseres Leben gelegt .
Thank you.	Vielen Dank .
I'd like to talk to you today about the scale of the scientific effort that goes into making the headlines you see in the paper.	Heute möchte ich mit Ihnen über das Ausmaß der wissenschaftlichen Anstrengungen sprechen , welches in die Erstellung der Schlagzeilen geht , die man in der Zeitung sieht .
Headlines that look like this when they have to do with climate change, and headlines that look like this when they have to do with air quality or smog.	Schlagzeilen , die aussehen wie diese , wenn sie mit dem Klimawandel zu tun haben und Schlagzeilen , die aussehen wie diese wenn sie mit Luftqualität und Smog zu tun haben .
They are both two branches of the same field of atmospheric science.	Sie sind beide Arten des selben Felds von atmosphärischen Wissenschaften .
Recently the headlines looked like this when the Intergovernmental Panel on Climate Change, or IPCC, put out their report on the state of understanding of the atmospheric system.	In letzter Zeit sahen die Schlagzeilen so aus , wenn das multiregierungs-Panel für Klimawandel , oder IPCC , ihren Bericht über die Lage des Verständnisses des atmosphärischen Systems veröffentlichte .
That report was written by 620 scientists from 40 countries.	Dieser Bericht wurde von 620 Wissenschaftlern aus 40 Ländern geschrieben .
They wrote almost a thousand pages on the topic.	Sie schrieben fast tausend Seiten über das Thema .
And all of those pages were reviewed by another 400-plus scientists and reviewers, from 113 countries.	Und all diese Seiten wurden von weiteren mehr als 400 Wissenschaftlern und Gutachtern aus 113 Ländern korrigiert .
Over 15,000 scientists go to San Francisco every year for that.	Über 15 .000 Wissenschaftler kommen dafür jedes Jahr nach San Francisco .
And every one of those scientists is in a research group, and every research group studies a wide variety of topics.	Und jeder von diesen Wissenschaftlern ist in einer Forschungsgruppe , und jede Forschungsgruppe befasst sich mit einer Vielzahl von Themen .
For us at Cambridge, it's as varied as the El Niño oscillation, which affects weather and climate, to the assimilation of satellite data, to emissions from crops that produce biofuels, which is what I happen to study.	Für uns in Cambridge ist das so vielfältig wie das El Niño Phänomen , welches das Wetter und Klima beeinflusst , oder die Anpassung von Satellitendaten , bis hin zu Emissionen durch Saaten die Biokraftstoffe produzieren , was ich zufällig studiere .
And in each one of these research areas, of which there are even more, there are PhD students, like me, and we study incredibly narrow topics, things as narrow as a few processes or a few molecules.	Und in jedem von diesen Forschungsgebieten , von denen es noch viel mehr gibt , gibt es Doktoranden , wie mich , und wir studieren unglaublich fokussierte Themen , Sachen so fokussiert wie ein paar einzelne Prozesse oder ein paar Moleküle .
The weight of a paper clip is approximately equal to 900 zeta-illion -- 10 to the 21st -- molecules of isoprene.	Das Gewicht einer Papierklammer ist ungefähr das gleiche wie 900 zeta-illionen -- 10 bis zum 21 . -- Moleküle von Isopren .
But despite its very small weight, enough of it is emitted into the atmosphere every year to equal the weight of all the people on the planet.	Aber abseits seines kleinen Gewichts , wird genug von ihm jedes Jahr in die Atmosphäre entlassen um das Gewicht aller Menschen auf dem Planeten aufzuwiegen .
And because it's so much stuff, it's really important for the atmospheric system.	Und weil es soviel davon ist , ist es wirklich wichtig für das atmosphärische System .
Because it's important to the atmospheric system, we go to all lengths to study this thing.	Weil es wichtig für das atmosphärische System ist , versuchen wir alles um das Ding zu studieren .
We blow it up and look at the pieces.	Wir blasen es auf und gucken uns die Teile an .
This is the EUPHORE Smog Chamber in Spain.	Das ist die EUPHORE Smog Kammer in Spanien .
Atmospheric explosions, or full combustion, takes about 15,000 times longer than what happens in your car.	Atmosphärische Explosionen oder komplette Verbrennung dauert ungefähr 15 .000 mal länger als was in Ihrem Auto passiert .
But still, we look at the pieces.	Aber trotzdem sehen wir uns die Teile an .
We run enormous models on supercomputers; this is what I happen to do.	Wir lassen auf Supercomputern riesige Modelle laufen; das ist zufällig , was ich mache .
Our models have hundreds of thousands of grid boxes calculating hundreds of variables each, on minute timescales.	Unsere Modelle haben hunderttausende von Rasterboxen , welche jede in Minutenabständen hunderte von Variablen errechnen .
And it takes weeks to perform our integrations.	Und es dauert Wochen um unsere Integrationen zu vervollständigen .
And we perform dozens of integrations in order to understand what's happening.	Und wir machen Dutzende von Integrationen um zu verstehen was vor sich geht .
We also fly all over the world looking for this thing.	Ausserdem fliegen wir über die ganze Welt und suchen nach dem Ding .
We found a global atmospheric watchtower there, in the middle of the rainforest, and hung hundreds of thousands of dollars worth of scientific equipment off this tower, to look for isoprene, and of course, other things while we were there.	Wir fanden einen globalen , atmosphärischen Wachturm dort in der Mitte des Regenwaldes und hingen wissenschaftliche Geräte im Wert von mehreren hunderttausend Dollar von dem Turm , um nach Isopren zu suchen , und natürlich nach anderen Dingen , wenn wir schon mal da wären .
This is the tower in the middle of the rainforest, from above.	Dies ist der Turm inmitten des Regenwaldes , von oben .
And this is the tower from below.	Und dies ist der Turm von unten .
And on part of that field campaign we even brought an aircraft with us.	Und auf Teilen des Feldzuges hatten wir sogar ein Flugzeug dabei .
And this plane, the model, BA146, which was run by FAAM, normally flies 120 to 130 people.	Und dieses Flugzeug , das Modell BA146 was von FAAM betrieben wurde , fliegt normalerweise mit 120 bis 130 Personen .
So maybe you took a similar aircraft to get here today.	Also haben Sie vielleicht ein ähnliches Flugzeug benutzt um heute herzukommen .
We have to fly at a special incline in order to make the measurements.	Wir mussten in einer speziellen Steigung fliegen um die Messungen durchzuführen .
We hire military and test pilots to do the maneuvering.	Wir stellen Militär- oder Testpiloten an um das Fliegen zu übernehmen .
We have to get special flight clearance.	Wir müssen dafür spezielle Luftraumklärung bekommen .
And as you come around the banks in these valleys, the forces can get up to two Gs.	Und wenn man in die Böschungen dieser Täler kommt können die G-Kräfte bis zu 2G betragen .
And the scientists have to be completely harnessed in in order to make measurements while they're on board.	Und die Wissenschaftler müssen vollständig befestigt werden , um die Messungen durchzuführen , während sie an Bord sind .
So, as you can imagine, the inside of this aircraft doesn't look like any plane you would take on vacation.	Wie Sie sich also vorstellen können sieht das Innere dieses Flugzeugs nicht wie jedes andere aus mit welchem Sie in den Urlaub fliegen würden .
It's a flying laboratory that we took to make measurements in the region of this molecule.	Es ist ein fliegendes Labor mit dem wir die Messungen in der Region dieses Moleküls durchführten .
We do all of this to understand the chemistry of one molecule.	Wir machen all dies um die Chemie eines einzelnen Moleküls zu verstehen .
And when one student like me has some sort of inclination or understanding about that molecule, they write one scientific paper on the subject.	Und wenn ein Student wie ich eine Art Neigung dazu hat oder etwas über das Molekül herausfindet , schreibt er eine wissenschaftliche Arbeit über das Thema .
And out of that field campaign we'll probably get a few dozen papers on a few dozen processes or molecules.	Und aus diesem Feldzug werden wir wahrscheinlich ein paar Dutzend Artikel über ein paar Dutzend Prozesse oder Moleküle bekommen .
And as a body of knowledge builds up, it will form one subsection, or one sub-subsection of an assessment like the IPCC, although we have others.	Und während sich das gesammelte Wissen entwickelt formt sich eine Unterklasse , oder Unterunterklasse einer Prüfung wie die der IPCC , obwohl es noch andere gibt .
And each one of the 11 chapters of the IPCC has six to ten subsections.	Und jedes dieser 11 Kapitel der IPCC hat sechs bis zehn Unterkapitel .
So you can imagine the scale of the effort.	Sie können sich also das Ausmaß dieser Anstrengungen vorstellen .
In each one of those assessments that we write, we always tag on a summary, and the summary is written for a non-scientific audience.	In jeder dieser Beurteilungen die wir schreiben , packen wir immer eine Zusammenfassung dazu , die für ein nicht-wissenschaftliches Publikum geschrieben ist .
And we hand that summary to journalists and policy makers, in order to make headlines like these.	Und diese Zusammenfassung teilen wir mit Journalisten und politischen Entscheidungsträgern , um Schlagzeilen wie diese zu machen .
Thank you very much.	Ich danke Ihnen vielmals .
You can mimic what you can see.	Sie können nachahmen , was sie sehen .
You can program the hundreds of muscles in your arm.	Sie können die hunderte von Muskeln in Ihrem Arm programmieren .
Soon, you'll be able to look inside your brain and program, control the hundreds of brain areas that you see there.	Schon bald werden Sie in ihr Gehirn sehen können , die hunderte Gehirnbereiche zu programmieren , zu steuern , die Sie dort sehen .
I'm going to tell you about that technology.	Ich werde Ihnen von dieser Methode erzählen .
People have wanted to look inside the human mind, the human brain, for thousands of years.	Leute haben schon in den menschlichen Verstand , das menschliche Gehirn schauen wollen , seit Jahrtausenden .
Well, coming out of the research labs just now, for our generation, is the possibility to do that.	Nun , entwickelt in den Versuchslaboren , hat unsere Generation genau jetzt die Möglichkeit , dies zu tun .
People envision this as being very difficult.	Leute stellen sich das sehr kompliziert vor .
You had to take a spaceship, shrink it down, inject it into the bloodstream.	Man müsse ein Raumschiff nehmen , es schrumpfen , es in den Blutkreislauf injizieren .
It was terribly dangerous.	Es wäre schrecklich gefährlich .
You could be attacked by white blood cells in the arteries.	Man könnte in den Arterien angegriffen werden von weißen Blutkörperchen .
But now, we have a real technology to do this.	Doch nun haben wir tatsächlich eine Methode , dies zu tun .
We're going to fly into my colleague Peter's brain.	Wir werden in das Gehirn meines Kollegen Peter fliegen .
We're going to do it non-invasively using MRI.	Wir werden dies ohne Eingriff machen , mittels MRI .
We will be able to fly into the anatomy of Peter's brain -- literally, fly into his body -- but more importantly, we can look into his mind.	Wir werden in der Lage sein in die Anatomie von Peters Gehirn zu fliegen -- buchstäblich in seinen Körper zu fliegen -- doch viel wichtiger: Wir können in seinen Verstand sehen .
When Peter moves his arm, that yellow spot you see there is the interface to the functioning of Peter's mind taking place.	Wenn Peter seinen Arm bewegt , ist dieser gelbe Fleck den Sie dort sehen die entsprechende Stelle zur Tätigkeit , die in Peters Verstand geschiet .
Now you've seen before that with electrodes you can control robotic arms, that brain imaging and scanners can show you the insides of brains.	Sie haben zuvor sicherlich bereits gesehen , dass man mit Elektroden Roboterarme steuern kann; dass Gehirnabbildungen und -abtaster das Innere des Gehirns darstellen können .
What's new is that that process has typically taken days or months of analysis.	Neu ist , dass dieser Vorgang üblicherweise Tage oder Monate der Analyse benötigte .
We've collapsed that through technology to milliseconds, and that allows us to let Peter to look at his brain in real time as he's inside the scanner.	Wir haben dies mittels Technik auf Millisekunden reduziert , und dies erlaubt Peter sein Gehirn live zu betrachten , während er im Abtaster ist .
He can look at these 65,000 points of activation per second.	Er kann diese 65 .000 Erregerpunkte pro Sekunde betrachten .
If he can see this pattern in his own brain, he can learn how to control it.	Wenn er dieses Raster im eigenen Gehirn sieht , kann er lernen , es zu steuern .
There have been three ways to try to impact the brain: the therapist's couch, pills and the knife.	Es gab bisher drei Möglichkeiten das Gehirn zu beeinflussen: das Sofa eines Therapeuten , Tabletten oder das Messer .
This is a fourth alternative that you are soon going to have.	Dies ist eine vierte Möglichkeit , die Sie schon bald haben werden .
We all know that as we form thoughts, they form deep channels in our minds and in our brains.	Wir alle wissen , dass wenn wir Gedanken bilden , bilden diese verborgene Wege in unserem Verstand und unserem Gehirn .
But if you're still in pain in six months' or six years' time, it's because these circuits are producing pain that's no longer helping you.	Doch wenn Sie über sechs Monate oder sechs Jahre noch immer Schmerz spüren , liegt es an Verbindungen , die Schmerz produzieren , der Ihnen nicht länger hilfreich ist .
If we can look at the activation in the brain that's producing the pain, we can form 3D models and watch in real time the brain process information, and then we can select the areas that produce the pain.	Wenn wir die Erregerpunkte im Gehirn sehen können , die den Schmerz verursachen , können wir 3D Abbilder entwerfen und live die Anzeige des Denkvorgangs betrachten , um dann die Bereiche herauslesen zu können , die den Schmerz verursachen .
So put your arms back up and flex your bicep.	Also heben Sie nochmals Ihre Arme und beugen Sie Ihren Bizeps .
Now imagine that you will soon be able to look inside your brain and select brain areas to do that same thing.	Nun stellen Sie sich vor , Sie können bald in Ihren Verstand sehen und Gehirnbereiche herauslesen , die genau diese Sache ausführen .
What you're seeing here is, we've selected the pathways in the brain of a chronic pain patient.	Was Sie hier sehen: Wir haben die Gehirnbahnen eines chronischen Schmerzpatienten markiert .
This may shock you, but we're literally reading this person's brain in real time.	Das mag Sie erschüttern , doch wir lesen im wahrsten Sinne des Wortes live den Verstand dieser Person .
They're watching their own brain activation, and they're controlling the pathway that produces their pain.	Sie beobachten ihre eigene Gehirnregung und sie programmieren die Gehirnbahn , die ihren Schmerz verursacht .
They're learning to flex this system that releases their own endogenous opiates.	Sie lernen den Ablauf zu beugen , der ihre eigenen endogenen Opiate freisetzt .
As they do it, in the upper left is a display that's yoked to their brain activation of their own pain being controlled.	Während sie dies machen , ist oben links eine Anzeige , die verbunden ist mit den Gehirnregungen , die ihren eigenen Schmerz regeln .
When they control their brain, they can control their pain.	Wenn sie ihren Verstand regeln , können sie ihren Schmerz regeln .
This is an investigational technology, but, in clinical trials, we're seeing a 44 to 64 percent decrease in chronic pain patients.	Dies ist eine experimentelle Methode , doch in klinischen Untersuchungen sehen wir eine 44 bis 64 prozentige Abnahme von chronischen Schmerzpatienten .
When you do, what do you want to control?	Wenn Sie dies machen , was werden Sie kontrollieren wollen ?
You will be able to look at all the aspects that make you yourself, all your experiences.	Sie werden in der Lage sein , alle Erscheinungen zu betrachten , die Sie ausmachen; alle Ihre Erfahrungen .
These are some of the areas we're working on today that I don't have time to go into in detail.	Dieses sind einige der Bereiche , an denen wir heute arbeiten , zu denen ich die Zeit nicht habe , auf Details einzugehen .
But I want to leave with you the big question.	Doch ich möchte Ihnen die große Frage überlassen .
We are the first generation that's going to be able to enter into, using this technology, the human mind and brain.	Wir sind die erste Generation , die in der Lage sein wird , einzusteigen – - mittels dieser Methode - in Verstand und Gehirn des Menschen .
Where will we take it?	Wohin werden wir es bringen ?
Evidence suggests that humans in all ages and from all cultures create their identity in some kind of narrative form.	Die Anzeichen sprechen dafür , dass Menschen jeden Alters und aus allen Kulturen ihre Identität in einer Art narrativer Form schaffen .
From mother to daughter, preacher to congregant, teacher to pupil, storyteller to audience.	Von Mutter zu Tochter , Priester zu Gemeindemitglied , Lehrer zu Schüler , Erzähler zum Publikum .
Whether in cave paintings or the latest uses of the Internet, human beings have always told their histories and truths through parable and fable.	Ob in Höhlenmalereien oder mit den Möglichkeiten des Internets , haben Menschen immer ihre Geschichten und Wahrheiten durch Parabeln und Fabeln erzählt .
We are inveterate storytellers.	Wir sind chronische Geschichtenerzähler .
But where, in our increasingly secular and fragmented world, do we offer communality of experience, unmediated by our own furious consumerism?	Aber wo in unserer immer zunehmend säkularisierten und zerstückelten Welt bieten wir eine Gemeinschaftlichkeit der Erfahrung , die unbeeinflusst von unserem wilden Konsumdenken ist ?
And what narrative, what history, what identity, what moral code are we imparting to our young?	Welche Erzählung , welche Geschichte , welche Identität , welchen moralischen Code geben wir an unsere Kinder weiter ?
Cinema is arguably the 20th century's most influential art form.	Das Kino ist wohl die einflussreichste Kunstform des 20 . Jahrhunderts .
Its artists told stories across national boundaries, in as many languages, genres and philosophies as one can imagine.	Seine Künstler erzählten Geschichten über Ländergrenzen hinweg in so vielen Sprachen , Genres und Philosophien , wie man sich nur vorstellen kann .
Indeed, it is hard to find a subject that film has yet to tackle.	Es ist in der Tat schwer ein Thema zu finden , dessen sich noch kein Film angenommen hat .
During the last decade we've seen a vast integration of global media, now dominated by a culture of the Hollywood blockbuster.	Während des letzten Jahrzehnts haben wir eine enorme Verflechtung globaler Medien gesehen , die nun von der Kultur der Hollywood-Blockbuster dominiert werden .
We are increasingly offered a diet in which sensation, not story, is king.	Wir bekommen zunehmend eine Diät vorgesetzt , in der der Sinneseindruck , nicht die Geschichte , dominiert .
What was common to us all 40 years ago -- the telling of stories between generations -- is now rarified.	Was für uns alle vor 40 Jahren normal war – das Erzählen von Geschichten zwischen Generationen – ist nun selten .
As a filmmaker, it worried me.	Als Filmproduzentin machte mir das Sorgen .
As a human being, it puts the fear of God in me.	Als menschliches Wesen versetzt es mich in Angst und Schrecken .
What future could the young build with so little grasp of where they've come from and so few narratives of what's possible?	Welche Zukunft können unsere Kinder aufbauen mit so wenig Verständnis woher sie kommen und so wenigen Geschichten über das was möglich ist ?
The irony is palpable; technical access has never been greater, cultural access never weaker.	Die Ironie ist fühlbar; der Zugang zu Technik war nie größer , der Zugang zu Kultur nie schwächer .
And so in 2006 we set up FILMCLUB, an organization that ran weekly film screenings in schools followed by discussions.	Und deshalb gründeten wir 2006 FILMCLUB , eine Organisation , die wöchentlich Filme in Schulen vorführte und anschließend diskutierte .
If we could raid the annals of 100 years of film, maybe we could build a narrative that would deliver meaning to the fragmented and restless world of the young.	Mit dem Filmarchiv der letzten 100 Jahre könnten wir vielleicht eine Geschichte schaffen , die der zerstückelten und unruhigen Welt der Jugend Sinn geben würde .
Given the access to technology, even a school in a tiny rural hamlet could project a DVD onto a white board.	Durch Zugang zu Technologie könnte sogar eine Schule in einem bäuerlichen Dorf eine DVD auf eine Leinwand projizieren .
In the first nine months we ran 25 clubs across the U.K., with kids in age groups between five and 18 watching a film uninterrupted for 90 minutes.	In den ersten neun Monaten betrieben wir 25 Vereine in Großbritannien , in denen Kinder zwischen 5 und 18 für 90 Minuten ununterbrochen einen Film schauen .
The films were curated and contextualized.	Die Filme waren kuratiert und kontextualisiert .
But the choice was theirs, and our audience quickly grew to choose the richest and most varied diet that we could provide.	Aber die Wahl war die ihre , und unser Publikum mauserte sich schnell zu Wählern der ergiebigsten und abwechslungsreichsten Kost , die wir anbieten konnten .
The outcome, immediate.	Das Ergebnis kam sofort .
It was an education of the most profound and transformative kind.	Es war Bildung der tiefgreifendsten und formenden Art .
In groups as large as 150 and as small as three, these young people discovered new places, new thoughts, new perspectives.	In Gruppen so groß wie 150 und so klein wie drei entdeckten diese jungen Menschen neue Orte , neue Gedanken , neue Perspektiven .
By the time the pilot had finished, we had the names of a thousand schools that wished to join.	Als der Pilotversuch beendet war , hatten wir die Namen von tausend Schulen , die beitreten wollten .
The film that changed my life is a 1951 film by Vittorio De Sica, "Miracle in Milan."	Der Film , der mein Leben verändert hat , ist ein Film aus dem Jahr 1951 von Vittorio De Sica , "Das Wunder von Mailand" .
It's a remarkable comment on slums, poverty and aspiration.	Er ist ein bemerkenswerter Kommentar zu Slums , Armut und Hoffnung .
I had seen the film on the occasion of my father's 50th birthday.	Ich hatte den Film zum 50 . Geburtstag meines Vaters gesehen .
Technology then meant we had to hire a viewing cinema, find and pay for the print and the projectionist.	Damals mussten wir dazu einen Kinosaal mieten , den Film finden und die Entwicklung und den Vorführer bezahlen .
But for my father, the emotional and artistic importance of De Sica's vision was so great that he chose to celebrate his half-century with his three teenage children and 30 of their friends, "In order," he said, "to pass the baton of concern and hope on to the next generation."	Aber für meinen Vater war die emotionale und künstlerische Bedeutung von De Sicas Vision so groß , dass er beschloss , seinen 50 . Geburtstag mit seinen drei Kindern im Teenageralter und 30 ihrer Freunde zu feiern . "Um" , sagte er , "die Verantwortung über Sorgen und Hoffnung an die nächste Generation weiterzugeben ."
In the last shot of "Miracle in Milan," slum-dwellers float skyward on flying brooms.	In der letzten Einstellung von "Das Wunder von Mailand" schweben Slumbewohner auf fliegenden Besen gen Himmel .
Sixty years after the film was made and 30 years after I first saw it, I see young faces tilt up in awe, their incredulity matching mine.	Sechzig Jahre nach der Produktion des Films und 30 Jahre , nachdem ich ihn zum ersten Mal sah , sehe ich junge Gesichter , die sich in Ehrfurcht neigen . Ihre Ungläubigkeit entspricht meiner .
And the speed with which they associate it with "Slumdog Millionaire" or the favelas in Rio speaks to the enduring nature.	Und die Geschwindigkeit , mit der sie ihn "Slumdog Millionaire" oder den Favelas in Rio zuordnen , spricht von der nachhaltigen Art .
Made in 1939, the film is older than most of our members' grandparents.	Gedreht im Jahr 1939 , ist der Film älter als die meisten Großeltern unserer Mitglieder .
Frank Capra's classic values independence and propriety.	Frank Capras Klassiker schätzt Unabhängigkeit und Anstand .
It shows how to do right, how to be heroically awkward.	Er zeigt , wie man Gutes tut , wie man heldenhaft unangenehm sein kann .
It is also an expression of faith in the political machine as a force of honor.	Er ist auch Ausdruck des Glaubens in die politische Maschine als eine Kraft der Ehre .
And it was with great delight that we found young people up and down the country explaining with authority what filibustering was and why the Lords might defy their bedtime on a point of principle.	Und es war eine große Freude , dass wir junge Menschen im ganzen Land fanden , die mit Kompetenz erklärten , was Filibustiererei ist und warum die Lords für ein Prinzip ihren Schlaf vernachlässigten .
After all, Jimmy Stewart filibustered for two entire reels.	Immerhin erstreckte sich Jimmy Stewarts Ermüdungsrede über zwei ganze Filmrollen .
In choosing "Hotel Rwanda," they explored genocide of the most brutal kind.	Durch die Auswahl von "Hotel Ruanda" erforschten sie Völkermord der brutalsten Art .
It provoked tears as well as incisive questions about unarmed peace-keeping forces and the double-dealing of a Western society that picks its moral fights with commodities in mind.	Er provozierte Tränen als auch prägnante Fragen über unbewaffnete Friedenstruppen und die Doppelzüngigkeit einer westlichen Gesellschaft , die ihre moralischen Kämpfe wegen Ressourcen eingeht .
And when "Schindler's List" demanded that they never forget, one child, full of the pain of consciousness, remarked, "We already forgot, otherwise how did 'Hotel Rwanda' happen?"	Und als "Schindlers Liste" verlangte , dass sie nie vergessen sollen , bemerkte ein Kind voller Gewissensbisse: "Wir haben schon vergessen , wie hätte sonst 'Hotel Ruanda' passieren können ?"
As they watch more films their lives got palpably richer.	Als sie mehr Filme sahen , wurde ihr Leben spürbar reicher .
They celebrated a change in attitude towards non-white Britons, but railed against our restless school system that does not value collective identity, unlike that offered by Sidney Poitier's careful tutelage.	Sie feierten eine Änderung der Haltung gegenüber nicht-weißen Briten , aber schimpften über unser unausgeglichenes Schulsystem , das kollektive Identität nicht wertschätzt , im Gegensatz zu dem unter den Fittichen von Sidney Poitier .
By now, these thoughtful, opinionated, curious young people thought nothing of tackling films of all forms -- black and white, subtitled, documentary, non-narrative, fantasy -- and thought nothing of writing detailed reviews that competed to favor one film over another in passionate and increasingly sophisticated prose.	Diese jungen . nachdenklichen , eigensinnigen und neugierigen Menschen stellen sich jetzt jeder Art von Film – schwarz-weiß , mit Untertiteln , Dokumentarfilme , nicht-narrativ , Fantasy – und schreiben anstandslos detaillierte Rezensionen , die sich beim Lobpreisen der Filme in leidenschaftlicher immer raffinierterer Prosa gegenseitig übertreffen .
Six thousand reviews each school week vying for the honor of being review of the week.	Sechstausend Rezensionen wetteifern wöchentlich um die Ehre , Rezension der Woche zu werden .
From 25 clubs, we became hundreds, then thousands, until we were nearly a quarter of a million kids in 7,000 clubs right across the country.	Aus 25 Vereinen wurden Hunderte , dann Tausende , bis wir fast eine Viertelmillion Kinder in 7 000 Vereinen aus dem ganzen Land waren .
And although the numbers were, and continue to be, extraordinary, what became more extraordinary was how the experience of critical and curious questioning translated into life.	Obwohl die Zahlen außergewöhnlich waren und es weiterhin sind , noch außergewöhnlicher wurde die Übertragung der Erfahrung des kritischen und neugierigen Fragens in den Alltag .
Some of our kids started talking with their parents, others with their teachers, or with their friends.	Einige unserer Kinder begannen mit ihren Eltern zu reden , andere mit ihren Lehrern oder mit ihren Freunden .
And those without friends started making them.	Und die ohne Freunde fingen an , welche zu finden .
The films provided communality across all manner of divide.	Die Filme lieferten Gemeinschaftlichkeit über alle Kluften .
And the stories they held provided a shared experience.	Und die enthaltenen Geschichten lieferten eine gemeinsame Erfahrung .
Who was right, who wrong?	Wer hatte Recht , wer Unrecht ?
What would they do under the same conditions?	Was würden sie unter den gleichen Bedingungen tun ?
Was the tale told well?	War die Geschichte gut erzählt ?
Was there a hidden message?	Gab es eine versteckte Botschaft ?
A tsunami of questions flew out of the mouths of children who the world didn't think were interested.	Eine Flut von Fragen entströmte den Mündern der Kinder , die die Welt bisher für uninteressiert gehalten hatte .
And they themselves had not known they cared.	Sie selbst waren sich ihres Interesses nicht bewusst gewesen .
And as they wrote and debated, rather than seeing the films as artifacts, they began to see themselves.	Und wie sie so schrieben und diskutierten , begannen sie , anstatt die Filme als Objekte zu sehen , sich selbst zu sehen .
I have an aunt who is a wonderful storyteller.	Meine Tante ist eine wunderbare Geschichtenerzählerin .
In a moment she can invoke images of running barefoot on Table Mountain and playing cops and robbers.	Sie kann blitzschnell Bilder erschaffen , wie wir barfuß auf den Tafelberg rennend Räuber und Gendarm spielen .
Quite recently she told me that in 1948, two of her sisters and my father traveled on a boat to Israel without my grandparents.	Vor kurzem erzählte sie mir , dass im Jahre 1948 zwei ihrer Schwestern und mein Vater ohne meine Großeltern auf einem Boot nach Israel reisten .
When the sailors mutinied at sea in a demand for humane conditions, it was these teenagers that fed the crew.	Als die Matrosen auf See mit der Forderung nach humanen Bedingungen meuterten , waren es diese Jugendlichen , die die Crew mit Essen versorgten .
I was past 40 when my father died.	Ich war über 40 , als mein Vater starb .
He never mentioned that journey.	Er hat diese Reise nie erwähnt .
My mother's mother left Europe in a hurry without her husband, but with her three-year-old daughter and diamonds sewn into the hem of her skirt.	Die Mutter meiner Mutter verließ in Eile Europa , ohne ihren Mann , aber mit ihrer dreijährigen Tochter und Diamanten , die in den Rocksaum eingenäht waren .
After two years in hiding, my grandfather appeared in London.	Nach zwei Jahren im Versteck erschien mein Großvater in London .
He was never right again.	Er wurde nie wieder in Ordnung .
And his story was hushed as he assimilated.	Und seine Geschichte verstummt , als er sich integrierte .
My story started in England with a clean slate and the silence of immigrant parents.	Meine Geschichte begann in England , ein Neuanfang mit dem Schweigen der eingewanderten Eltern .
I had "Anne Frank," "The Great Escape," "Shoah," "Triumph of the Will."	Ich hatte "Anne Frank" , "The Great Escape" , "Shoah" , "Triumph des Willens" .
It was Leni Riefenstahl in her elegant Nazi propaganda who gave context to what the family had to endure.	Es war Leni Riefenstahl mit ihrer eleganten Nazi-Propaganda , die dem , was meine Familie erleben musste , einen Kontext gab .
These films held what was too hurtful to say out loud, and they became more useful to me than the whispers of survivors and the occasional glimpse of a tattoo on a maiden aunt's wrist.	Diese Filme enthielten das , was zu sehr schmerzte um es laut zu sagen , und sie wurden für mich nützlicher als das Flüstern der Überlebenden und den gelegentlichen Blick auf ein Tattoo auf dem Handgelenk meiner altjüngferlichen Tante .
Purists may feel that fiction dissipates the quest of real human understanding, that film is too crude to tell a complex and detailed history, or that filmmakers always serve drama over truth.	Puristen denken vielleicht , dass Fiktion die Suche nach echtem menschlichen Verständnis zerstreut , dass Film zu grob ist , um eine komplexe und detaillierte Geschichte erzählen , oder dass Filmemacher immer Drama über die Wahrheit stellen .
But within the reels lie purpose and meaning.	Aber Filmrollen enthalten Zweck und Bedeutung .
As one 12-year-old said after watching "Wizard of Oz," "Every person should watch this, because unless you do you may not know that you too have a heart."	Ein 12-Jähriger sagte nach dem Sehen von "Der Zauberer von Oz": "Jeder Mensch sollte das sehen , denn wenn das nicht tun , wissen sie vielleicht nicht , dass sie auch ein Herz haben ."
We honor reading, why not honor watching with the same passion?	Warum honorieren wir das Sehen nicht mit der gleichen Leidenschaft wie das Lesen ?
Consider "Citizen Kane" as valuable as Jane Austen.	"Citizen Kane" sollte so wertvoll sein wie Jane Austen .
Agree that "Boyz n the Hood," like Tennyson, offers an emotional landscape and a heightened understanding that work together.	Stimmen Sie zu , dass "Boyz n the Hood" wie Tennyson eine emotionale Landschaft und ein erhöhtes Verständnis bietet , die zusammenarbeiten .
Each a piece of memorable art, each a brick in the wall of who we are.	Jedes ein Stück denkwürdiger Kunst , jedes ein Stein in der Wand , die uns ausmacht .
And it's okay if we remember Tom Hanks better than astronaut Jim Lovell or have Ben Kingsley's face superimposed onto that of Gandhi's.	Und es ist okay , wenn wir uns besser an Tom Hanks erinnern als an den Astronauten Jim Lovell oder Ben Kingsleys Gesicht das von Gandhi überlagert .
And though not real, Eve Harrington, Howard Beale, Mildred Pierce are an opportunity to discover what it is to be human, and no less helpful to understanding our life and times as Shakespeare is in illuminating the world of Elizabethan England.	Und obwohl nicht real , bieten Eve Harrington , Howard Beale , Mildred Pierce die Gelegenheit zu entdecken , was Menschsein bedeutet . Sie sind genau so hilfreich für das Verständnis unseres Lebens und unserer Zeit wie Shakespeare es ist im Beleuchten der Welt des elisabethanischen Englands .
We guessed that film, whose stories are a meeting place of drama, music, literature and human experience, would engage and inspire the young people participating in FILMCLUB.	Wir ahnten , dass Film , dessen Geschichten ein Ort der Begegnung von Theater , Musik , Literatur und menschlicher Erfahrung sind , junge Teilnehmer am FILMCLUB engagieren und inspirieren würde .
What we could not have foreseen was the measurable improvements in behavior, confidence and academic achievement.	Wir konnten aber nicht die messbaren Verbesserungen im Verhalten , im Selbstvertrauen und in der akademischen Leistung vorhersehen .
Once-reluctant students now race to school, talk to their teachers, fight, not on the playground, but to choose next week's film -- young people who have found self-definition, ambition and an appetite for education and social engagement from the stories they have witnessed.	Ehemals zurückhaltende Schüler rennen nun zur Schule , sprechen mit ihren Lehrern , kämpfen , nicht auf dem Spielplatz , sondern um den Film für nächste Woche zu wählen – junge Menschen haben sich selbst , Ehrgeiz , Lust auf Bildung und soziales Engagement gefunden , aus den Geschichten , die sie erlebt haben .
Our members defy the binary description of how we so often describe our young.	Unsere Mitglieder trotzen der binären Beschreibung , mit der wir so oft unsere Kinder beschreiben .
They are neither feral nor myopically self-absorbed.	Sie sind weder wild noch nur mit sich selbst beschäftigt .
They are, like other young people, negotiating a world with infinite choice, but little culture of how to find meaningful experience.	Sie sind wie andere jungen Menschen , sie verhandeln über eine Welt mit unendlicher Auswahl , aber wenig Ahnung , wie man sinnstiftende Erfahrungen findet .
We appeared surprised at the behaviors of those who define themselves by the size of the tick on their shoes, yet acquisition has been the narrative we have offered.	Wir schienen überrascht über die Verhaltensweisen , von denen , die sich über die Marke ihrer Schuhe definieren , doch war Konsum die Geschichte , die wir angeboten hatten .
If we want different values we have to tell a different story, a story that understands that an individual narrative is an essential component of a person's identity, that a collective narrative is an essential component of a cultural identity, and without it it is impossible to imagine yourself as part of a group.	Wenn wir andere Werte haben wollen , müssen wir eine andere Geschichte erzählen , eine Geschichte , die versteht , dass eine persönliche Erzählung ein wesentlicher Bestandteil der Identität einer Person ist . Eine kollektive Erzählung ist ein wesentlicher Bestandteil einer kulturellen Identität , und ohne sie ist es unmöglich , sich als Teil einer Gruppe vorzustellen .
Because when these people get home after a screening of "Rear Window" and raise their gaze to the building next door, they have the tools to wonder who, apart from them, is out there and what is their story.	Denn wenn diese Menschen nach einer Vorführung von "Das Fenster zum Hof" nach Hause kommen und ihren Blick auf das Gebäude nebenan richten , haben sie die Mittel zu fragen , wer außer ihnen noch da draußen ist und was ihre Geschichte ist .
Thank you.	Vielen Dank .
Thank you.	Pfeifen Danke schön .
Thank you very much.	Vielen Dank .
That was whistling.	So kann Pfeifen klingen .
I'm trying to do this in English.	Ich werde versuchen , Englisch zu sprechen .
What is a chubby, curly-haired guy from Holland -- why is he whistling?	Was macht ein molliger , kraushaariger Typ aus Holland – was hat so jemand wie mich dazu gebracht , zu Pfeifen ?
Well actually, I've [been] whistling since the age of four, about four.	Nun , ich pfeife eigentlich seit ich vier bin - so ungefähr seitdem .
My dad was always whistling around the house, and I just thought that's part of communication in my family.	Mein Vater hat immer im Haus herum gepfiffen , und ich dachte immer , das ist in meiner Familie so eine Art Kommunikationsform .
So I whistled along with him.	Also hab ich mit ihm gepfiffen .
And actually, till I was 34, I always annoyed and irritated people with whistling, because, to be honest, my whistling is a kind of deviant behavior.	Und erst mit 34 Jahren , hab ich andere Menschen mit meiner Pfeiferei verägert und irritiert . Denn , um ehrlich zu sein , mein Pfeifen ist eine Art Verhaltensauffälligkeit .
And I also whistled at a Christmas Eve party with my family-in-law.	Und ich hab auch am Heiligen Abend bei der Familie meiner Frau gepfiffen .
And they had some, in my opinion, terrible Christmas music.	Die meiner Meinung nach grauenvolle Weihnachtsmusik hörten .
And when I hear music that I don't like, I try to make it better.	Und wenn ich Musik höre , die ich nicht mag , versuche ich sie zu verbessern .
So "Rudolph the Red-Nosed Reindeer" -- you know it?	Also: "Rudolph the Red-nosed Reindeer" – kennen Sie das ?
But it can also sound like this.	Aber es kann auch so klingen .
But during a Christmas party -- at dinner actually -- it's very annoying.	Aber bei einer Weihnachtsfeier – inbesondere beim Abendessen – kann das schon nerven .
So my sister-in-law asked me a few times, "Please stop whistling."	Also hat mich meine Schwägerin ein paar Mal gebeten , mit dem Pfeifen aufzuhören .
And I just couldn't.	Und ich konnte einfach nicht .
And at one point -- and I had some wine, I have to admit that -- at one point I said, "If there was a contest, I would join."	Und irgendwann – ich hatte zugegebenermaßen schon ein bisschen Wein getrunken – da sagte ich: "Wenn es einen Wettbewerb gäbe , würde ich daran teilnehmen ."
And two weeks later I received a text message: "You're going to America."	Und zwei Wochen später bekam ich eine S "Du fährst nach Amerika ."
So, okay, I'm going to America.	Nun gut , ich fahre nach Amerika .
I would love to, but why?	Liebend gerne , aber warum ?
So I immediately called her up, of course.	Also hab ich natürlich sofort angerufen .
She Googled, and she found this World Whistling Championship in America, of course.	Sie hatte gegoogelt und eine Pfeif-Weltmeisterschaft gefunden – natürlich in Amerika .
She didn't expect me to go there.	Sie dachte nicht , dass ich hinfahre .
And I would have lost my face.	Und ich hätte mein Gesicht verloren .
I don't know if that's correct English.	Ich weiß nicht , ob das korrektes Englisch ist .
But the Dutch people here will understand what I mean.	Aber die Niederländer unter Ihnen wissen , was gemeint ist .
I lost my face.	Mir ist das Gesicht runtergefallen .
And she thought, "He will never go there."	Und sie dachte , "Er wird da nie hinfahren ."
But actually I did.	Aber ich bin tatsächlich hingefahren .
So I went to Louisburg, North Carolina, southeast United States, and I entered the world of whistling.	Also bin ich nach Louisburg in North Carolina gereist , im Südosten der USA , und so kam ich zum ersten Mal mit der Welt des Pfeifens in Berührung .
And I also entered the world championship, and I won there in 2004.	Und ich hab 2004 auch an der Weltmeisterschaft teilgenommen und gewonnen .
That was great fun, of course.	Das war – Das war natürlich sehr lustig .
And to defend my title -- like judokas do and sportsmen -- I thought, well let's go back in 2005, and I won again.	Und um meinen Titel zu verteidigen – wie Judoka und andere Sportler das tun – dachte ich , ich mach das 2005 nochmal , und gewann wieder .
Then I couldn't participate for a few years.	Dann konnte ich ein paar Jahre nicht teilnehmen .
And in 2008 I entered again in Japan, Tokyo, and I won again.	Und bin 2008 wieder angetreten , in Japan , Tokyo , und ich habe wieder gewonnen .
So what happened now is I'm standing here in Rotterdam, in the beautiful city, on a big stage, and I'm talking about whistling.	Und jetzt nun ja , jetzt stehe ich hier in Rotterdam , einer wunderschönen Stadt , auf einer großen Bühne , und erzähle Ihnen was über Pfeifen .
And actually I earn my money whistling at the moment.	Und ich verdiene tatsächlich mein Geld mit Pfeifen , zumindest im Moment .
So I quit my day job as a nurse.	Ich hab meinen Hauptjob als Krankenpfleger aufgegeben .
And I try to live my dream -- well, actually, it was never my dream, but it sounds so good.	Und ich versuche , meinen Traum zu leben – nun ja , eigentlich war es nie ein Traum , aber es klingt einfach zu gut .
Okay, I'm not the only one whistling here.	Okay , aber ich bin nicht der Einzige hier , der pfeifen kann .
You say, "Huh, what do you mean?"	Sie denken sich jetzt: "Häh , von wem spricht der ?"
Well actually, you are going to whistle along.	Nun , Sie werden auch mitpfeifen .
No, you can't.	Nein , können Sie nicht .
Actually it's very simple.	Es ist echt ganz einfach .
The track that I will whistle is called "Fête de la Belle."	Das Stück , das ich pfeife , heißt "Fête de la Belle ."
It's about 80 minutes long.	Es ist ca . 80 Minuten lang .
And I want to first rehearse with you your whistling.	Und zunächst möchte ich mit Ihnen Ihr Pfeifen üben .
So I whistle the tone.	Also , ich pfeife einen Ton .
You whistle the same tone as me.	Sie pfeifen bitte den gleichen Ton wie ich .
I heard a wide variety of tones.	Ich habe da verschiedene Töne gehört .
This is very promising.	Das ist sehr vielversprechend .
This is very promising.	Das ist sehr vielversprechend .
I'll ask the technicians to start the music.	Ich werde die Techniker bitten , die Musik zu starten .
And if it's started, I just point where you whistle along, and we will see what happens.	Und wenn sie läuft , geb ich Ihnen ein Zeichen für Ihren Einsatz , und dann sehen wir einfach , was passiert .
Oh, hah.	Oh , ah ja ,
I'm so sorry, technicians.	tut mir leid , Techniker .
I'm so used to that.	Ich bin das schon so gewohnt .
I start it myself.	Ich starte es einfach selber .
Okay, here it is.	Okay , es geht los .
It's easy, isn't it?	Ganz einfach , oder ?
Max Westerman: Geert Chatrou, the World Champion [of] Whistling.	Max Westerman: Geert Chatrou , der Weltmeister im Pfeifen .
I'm here to show you how something you can't see can be so much fun to look at.	Ich möchte Ihnen zeigen , wie etwas Unsichtbares so schön anzuschauen sein kann .
You're about to experience a new, available and exciting technology that's going to make us rethink how we waterproof our lives.	Gleich erleben Sie eine neue , bereits existierende und aufregende Technologie , die uns ganz neu über Wasserfestigkeit nachdenken lässt .
What I have here is a cinder block that we've coated half with a nanotechnology spray that can be applied to almost any material.	Hier ist ein Betonschalstein , der zur Hälfte mit einem nanotechnologischen Spray , das fast auf jedem Material anwendbar ist , bedeckt ist .
It's called Ultra-Ever Dry, and when you apply it to any material, it turns into a superhydrophobic shield.	Es heißt Ultra-Ever Dry und bildet , auf ein Material aufgebracht , einen superhydrophobischen Schild .
So this is a cinder block, uncoated, and you can see that it's porous, it absorbs water.	Diese Hälfte hier ist unbehandelt . Der Beton ist porös und absorbiert Wasser .
Not anymore.	Aber nicht hier .
Porous, nonporous.	Porös , nicht porös .
So what's superhydrophobic?	Was bedeutet superhydrophobisch ?
Superhydrophobic is how we measure a drop of water on a surface.	So messen wir einen Wassertropfen auf einer Oberfläche .
The rounder it is, the more hydrophobic it is, and if it's really round, it's superhydrophobic.	Je runder er ist , desto hydrophobischer ist er . Wenn er ganz rund ist , ist er superhydrophobisch .
A freshly waxed car, the water molecules slump to about 90 degrees.	Bei einem frisch gewachsten Auto rutscht das Wasser bei Winkeln bis 90° ab .
A windshield coating is going to give you about 110 degrees.	Eine imprägnierte Windschutzscheibe erhöht das auf 110° .
But what you're seeing here is 160 to 175 degrees, and anything over 150 is superhydrophobic.	Aber das hier sind 160-175° , und alles über 150° ist superhydrophobisch .
So as part of the demonstration, what I have is a pair of gloves, and we've coated one of the gloves with the nanotechnology coating, and let's see if you can tell which one, and I'll give you a hint.	Als Teil der Demonstration habe ich ein Paar Handschuhe . Einer der Handschuhe ist mit der Nanotechnologie behandelt . Vielleicht finden Sie ja heraus , welcher . Ich gebe Ihnen einen Tipp .
Did you guess the one that was dry?	Haben Sie den trockenen entdeckt ?
When you have nanotechnology and nanoscience, what's occurred is that we're able to now look at atoms and molecules and actually control them for great benefits.	Nanotechnologie und Nanowissenschaft lassen uns Atome und Moleküle regelrecht steuern und daraus Vorteile gewinnen .
And we're talking really small here.	Es geht hier also um superkleine Dinge .
The way you measure nanotechnology is in nanometers, and one nanometer is a billionth of a meter, and to put some scale to that, if you had a nanoparticle that was one nanometer thick, and you put it side by side, and you had 50,000 of them, you'd be the width of a human hair.	Nanotechnologie wird in Nanometern gemessen , also ein Milliardstel Meter . Setzen wir das in einen Maßstab , nehmen wir einen Nanopartikel mit einem Nanometer Dicke und legen 50 .000 davon nebeneinander , hätten wir die Dicke eines menschlichen Haars .
So very small, but very useful.	Ungeheuer klein , aber ungeheuer nützlich .
And it's not just water that this works with.	Und das funktioniert nicht nur mit Wasser .
It's a lot of water-based materials like concrete, water-based paint, mud, and also some refined oils as well.	Es geht mit vielen wasserbasierten Materialien: Beton , wasserlösliche Farbe , Schlamm und auch einige raffinierte Öle .
You can see the difference.	Hier sehen Sie den Unterschied .
Moving onto the next demonstration, we've taken a pane of glass and we've coated the outside of it, we've framed it with the nanotechnology coating, and we're going to pour this green-tinted water inside the middle, and you're going to see, it's going to spread out on glass like you'd normally think it would, except when it hits the coating, it stops, and I can't even coax it to leave.	Auf zur nächsten Demonstration . Wir haben eine Glasscheibe von außen mit der Nanotechnologie beschichtet und gießen nun dieses grüngefärbte Wasser in die Mitte . Sie sehen , dass es sich normal über der Oberfläche verteilt , wie es das bei Glas tut , aber an der Beschichtung hört es auf und will von einfach nicht weiter .
It's that afraid of the water.	Es hat regelrecht Angst .
Well, the surface of the spray coating is actually filled with nanoparticles that form a very rough and craggly surface.	Die Oberfläche der Spraybeschichtung ist mit Nanopartikeln gefüllt , die eine sehr schroffe Oberfläche bilden .
You'd think it'd be smooth, but it's actually not.	Man könnte sie für glatt halten , sie ist es aber nicht .
And it has billions of interstitial spaces, and those spaces, along with the nanoparticles, reach up and grab the air molecules, and cover the surface with air.	Und Milliarden von Zwischenräumen greifen zusammen mit den Nanopartikeln nach den Luftmolekülen und bedecken die Oberfläche mit Luft .
It's an umbrella of air all across it, and that layer of air is what the water hits, the mud hits, the concrete hits, and it glides right off.	Als wäre ein Regenschirm aus Luft darüber , auf den das Wasser , der Schlamm , der Beton trifft , und sie rutschen davon ab .
So if I put this inside this water here, you can see a silver reflective coating around it, and that silver reflective coating is the layer of air that's protecting the water from touching the paddle, and it's dry.	Wenn ich das hier ins Wasser tauche , sehen Sie eine silberne Beschichtung und diese Beschichtung ist die Luftschicht , die das Wasser vom Benetzen des Paddels abhält . Es bleibt trocken .
So what are the applications?	Wie kann man das anwenden ?
I mean, many of you right now are probably going through your head.	Einige von Ihnen machen bestimmt gerade eine Liste .
Everyone that sees this gets excited, and says, "Oh, I could use it for this and this and this."	Alle , die das sehen , sind begeistert und sagen: "Oh , ich könnte es für dies und das einsetzen ."
The applications in a general sense could be anything that's anti-wetting.	Allgemein eignet sich die Anwendung für alles , das nicht nass werden soll .
We've certainly seen that today.	Das haben wir heute gesehen ,
It could be anything that's anti-icing, because if you don't have water, you don't have ice.	also zum Beispiel Vereisungsschutz , denn ohne Wasser gibt es kein Eis .
It could be anti-corrosion.	Oder Korrosionsschutz .
No water, no corrosion.	Kein Wasser , keine Korrosion .
It could be anti-bacterial.	Antibakterielle Anwendungen .
Without water, the bacteria won't survive.	Ohne Wasser können Bakterien nicht überleben .
And it could be things that need to be self-cleaning as well.	Und man könnte es für selbstreinigende Dinge verwenden .
So imagine how something like this could help revolutionize your field of work.	Stellen Sie sich vor , wie so etwas Ihr Berufsfeld revolutionieren könnte .
And I'm going to leave you with one last demonstration, but before I do that, I would like to say thank you, and think small.	Und ich zeige Ihnen noch eine letzte Demonstration , aber zuerst möchte ich mich bedanken , und: Immer schön klein denken .
You guys didn't hear about us cutting out the Design from TED?	Habt ihr nicht gehört , dass TED Design gestrichen hat ?
It's happening!	Es klappt !
I want to talk to you today a little bit about predictable irrationality.	Ich würde heute gerne ein wenig über vorhersehbare Irrationalität sprechen .
And my interest in irrational behavior started many years ago in the hospital.	Mein Interesse an irrationalem Verhalten begann vor vielen Jahren im Krankenhaus .
I was burned very badly.	Ich hatte damals schwere Verbrennungen ,
And if you spend a lot of time in hospital, you'll see a lot of types of irrationalities.	und wenn man lange Zeit im Krankenhaus ist , begegnet man vielen Arten von Irrationalität .
And the one that particularly bothered me in the burn department was the process by which the nurses took the bandage off me.	Was mich auf der Verbrennungsstation immer am meisten gestört hat war , wie die Krankenschwestern meine Verbände gewechselt haben .
Now, you must have all taken a Band-Aid off at some point, and you must have wondered what's the right approach.	Jeder von Ihnen hat schon mal ein Heftpflaster abgenommen und sich dabei irgendwann gefragt , was wohl besser sei:
Do you rip it off quickly -- short duration but high intensity -- or do you take your Band-Aid off slowly -- you take a long time, but each second is not as painful -- which one of those is the right approach?	Soll man es schnell abreißen -- Der Schmerz ist dann nur kurz aber dafür sehr intensiv -- oder es stattdessen langsam abziehen -- was zwar länger dauert , aber jeden einzelnen Moment erträglicher macht . Welches ist der richtige Ansatz ?
The nurses in my department thought that the right approach was the ripping one, so they would grab hold and they would rip, and they would grab hold and they would rip.	Die Schwestern auf meiner Station dachten , der richtige Ansatz wäre das Abreißen , also haben sie festgehalten und abgerissen , und festgehalten und abgerissen .
And because I had 70 percent of my body burned, it would take about an hour.	Und weil ich Verbrennungen an 70% meines Körpers hatte , dauerte das Ganze etwa eine Stunde .
And as you can imagine, I hated that moment of ripping with incredible intensity.	Wie Sie sich vorstellen können , habe ich den Moment des Abreißens unglaublich gehasst .
And the nurses told me two things.	Darauf sagten die Schwestern mir zwei Dinge .
They told me that they had the right model of the patient -- that they knew what was the right thing to do to minimize my pain -- and they also told me that the word patient doesn't mean to make suggestions or to interfere or ...	Sie sagten mir erstens , sie hätten das richtige Modell vom Patienten -- daß sie wüßten , was das Richtige sei um den Schmerz gering zu halten -- Und dann sagten sie mir , die Bedeutung des Wortes "Patient" habe nichts damit zu tun , Ratschläge zu geben , oder sich einzumischen , oder . . .
This is not just in Hebrew, by the way.	Das ist übrigens nicht nur im Hebräischen so ,
It's in every language I've had experience with so far.	sondern in jeder Sprache , mit der ich bis jetzt zu tun hatte .
And, you know, there's not much -- there wasn't much I could do, and they kept on doing what they were doing.	Und , wissen Sie , es gibt nicht viel -- es gab nicht viel , was ich tun konnte , also machten sie weiter mit dem was sie machten .
And about three years later, when I left the hospital, I started studying at the university.	Als ich dann etwa drei Jahre später aus dem Krankenhaus entlassen wurde , habe ich angefangen , an der Universität zu studieren
And one of the most interesting lessons I learned was that there is an experimental method that if you have a question you can create a replica of this question in some abstract way, and you can try to examine this question, maybe learn something about the world.	und eins der interessantesten Dinge , die ich dort gelernt habe war , daß es eine wissenschaftliche Methode gibt in der man eine Frage die man hat auf abstrakte Weise neu stellt und durch die Untersuchung dieser neuen Frage vielleicht etwas über die Welt erfahren kann .
So that's what I did.	Genau das habe ich also getan .
I was still interested in this question of how do you take bandages off burn patients.	Mich interessierte nämlich noch immer die Frage , wie man Verbrennungspatienten am besten die Verbände abnimmt .
So originally I didn't have much money, so I went to a hardware store and I bought a carpenter's vice.	Am Anfang hatte ich nicht viel Geld , also ging ich in einen Werkzeugladen und kaufte mir einen Schraubstock .
And I would bring people to the lab and I would put their finger in it, and I would crunch it a little bit.	Dann habe ich Leute in mein Labor gebracht , ihre Finger eingespannt und ihn ein bißchen gequetscht .
And I would crunch it for long periods and short periods, and pain that went up and pain that went down, and with breaks and without breaks -- all kinds of versions of pain.	Ich habe manchmal länger gequetscht und manchmal kürzer , manchmal mit ansteigendem Schmerz , manchmal mit absteigendem , mal mit Pause , mal ohne Pause - jede Art und Weise von Schmerz .
Or, if you had to choose between the last two, which one would you choose?	Oder , "Wenn sie sich zwischen den letzten beiden entscheiden müßten , Welchen Schmerz würden Sie wählen ?"
I kept on doing this for a while.	Das habe ich eine Zeit lang so betrieben .
And then, like all good academic projects, I got more funding.	Und dann bekam ich , wie jedes gute akademische Projekt , mehr Geld zugesprochen .
I moved to sounds, electrical shocks -- I even had a pain suit that I could get people to feel much more pain.	Ich beschäftigte mich mit Geräuschen , Elektroschocks -- Ich hatte sogar einen Schmerzanzug , mit dem ich sehr starke Schmerzen verursachen konnte .
But at the end of this process, what I learned was that the nurses were wrong.	Am Ende dieses Prozesses hat sich dann herausgestellt , daß die Krankenschwestern unrecht hatten .
Here were wonderful people with good intentions and plenty of experience, and nevertheless they were getting things wrong predictably all the time.	Sicherlich waren sie wundervolle Menschen mit guten Absichten und großer Erfahrung , aber trotzdem haben sie ständig und vorhersehbar die selben Fehler wiederholt .
It turns out that because we don't encode duration in the way that we encode intensity, I would have had less pain if the duration would have been longer and the intensity was lower.	Wie sich herausstellt , nehmen wir nämlich die Länge des Schmerzes und seine Intensität unterschiedlich wahr , weswegen ich weniger Schmerzen gehabt hätte , wenn es zwar länger wehgetan hätte aber dafür nicht so sehr .
It turns out it would have been better to start with my face, which was much more painful, and move toward my legs, giving me a trend of improvement over time -- that would have been also less painful.	Es wäre auch besser gewesen , mit meinem Gesicht anzufangen , weil es da sehr weh getan hat , und sich zu meinen Beinen vorzuarbeiten damit der Schmerz im Laufe der Zeit geringer wird -- auch das wäre weniger schmerzhaft gewesen .
And it also turns out that it would have been good to give me breaks in the middle to kind of recuperate from the pain.	Wir haben auch herausgefunden daß es gut gewesen wäre , hätte man mir zwischendurch Pausen gegeben um mich vom Schmerz zu erholen .
All of these would have been great things to do, and my nurses had no idea.	Alles tolle Sachen , die man mit mir hätte machen können , aber meine Pfleger hatten keine Ahnung .
And from that point on I started thinking, are the nurses the only people in the world who get things wrong in this particular decision, or is it a more general case?	Und dieser Punkt gab mir zu denken: Sind Krankenschwestern die einzigen auf der Welt , die sich in diesem Punkt täuschen , oder ist die Fehleinschätzung weiter verbreitet ?
And it turns out it's a more general case -- there's a lot of mistakes we do.	Wie sich herausstellt , ist sie weiter verbreitet -- Wir machen viele Fehler .
And I want to give you one example of one of these irrationalities, and I want to talk to you about cheating.	Ich möchte Ihnen ein Beispiel für solcherlei Irrationalität geben und mit Ihnen über Betrug reden .
And the reason I picked cheating is because it's interesting, but also it tells us something, I think, about the stock market situation we're in.	Ich beschäftige mich mit dem Betrügen weil es interessant ist , uns aber auch , wie ich meine , etwas über die gegenwärtige Börsenlage erzählen kann .
So, my interest in cheating started when Enron came on the scene, exploded all of a sudden, and I started thinking about what is happening here.	Mein Interesse am Betrügen begann als Enron die Bühne betrat und plötzlich explodierte und ich mich zu fragen begann , was gerade passiert war .
Is it the case that there was kind of a few apples who are capable of doing these things, or are we talking a more endemic situation, that many people are actually capable of behaving this way?	Gab es nur einige wenige schwarze Schafe die zu solchen Dingen fähig waren , oder war die Situation eher eine endemische ? Waren viele Menschen in der Lage , sich so zu verhalten ?
So, like we usually do, I decided to do a simple experiment.	Also begann ich wie so oft mit einem einfachen Experiment .
And here's how it went.	Und das sah so aus .
If you were in the experiment, I would pass you a sheet of paper with 20 simple math problems that everybody could solve, but I wouldn't give you enough time.	Wenn Sie in meinem Experiment waren , hätten Sie von mir ein Blatt Papier mit 20 einfachen Mathematikaufgaben bekommen , die jeder lösen kann -- aber ich hätte Ihnen nicht genug Zeit gegeben .
When the five minutes were over, I would say, "Pass me the sheets of paper, and I'll pay you a dollar per question."	Nach fünf Minuten hätte ich gesagt: "Geben Sie mir ihre Blätter und ich zahle Ihnen einen Dollar pro gelöster Aufgabe ."
Other people I would tempt to cheat.	Andere habe ich zum Schummeln verleitet .
I would pass their sheet of paper.	Ich habe ihnen die Blätter ausgeteilt
People now solved seven questions on average.	Und siehe da , plötzlich hat der Durchschnitt sieben Fragen beantwortet .
Now, it wasn't as if there was a few bad apples -- a few people cheated a lot.	Es ist nicht so , als gäbe es wenige schwarze Schafe -- als betrögen wenige Leute und diese dafür sehr viel .
Instead, what we saw is a lot of people who cheat a little bit.	Wir sahen stattdessen daß viele Leute betrügen , jeder von ihnen aber nur ein bißchen .
Now, in economic theory, cheating is a very simple cost-benefit analysis.	In der Wirtschaftstheorie ist Betrug nur eine einfache Kosten-Nutzen-Rechnung .
You say, what's the probability of being caught?	Wie hoch ist die Wahrscheinlichkeit , erwischt zu werden ?
How much do I stand to gain from cheating?	Wieviel wird es mir nützen , zu betrügen ?
And how much punishment would I get if I get caught?	Und wie schlimm wäre die Strafe , falls ich erwischt würde ?
And you weigh these options out -- you do the simple cost-benefit analysis, and you decide whether it's worthwhile to commit the crime or not.	Man wägt diese Fragen gegeneinander ab -- eben eine ganz einfache Kosten-Nutzen-Rechnung -- und entscheidet dann , ob es sich lohnt , ein Verbrechen zu begehen oder nicht .
So, we try to test this.	Also versuchten wir das zu überprüfen .
For some people, we varied how much money they could get away with -- how much money they could steal.	Bei manchen Testpersonen variierten wir , mit wieviel Geld sie davonkommen konnten -- Wieviel Geld sie stehlen durften .
We paid them 10 cents per correct question, 50 cents, a dollar, five dollars, 10 dollars per correct question.	Wir zahlten ihnen 10 cent pro richtiger Frage , 50 cent , einen Dollar , fünf Dollar , 10 Dollar pro richtiger Frage .
You would expect that as the amount of money on the table increases, people would cheat more, but in fact it wasn't the case.	Man könnte annehmen , daß , sobald die Summen höher wurden auch mehr betrogen wurde - aber dem war nicht so .
We got a lot of people cheating by stealing by a little bit.	Die meisten Leute betrogen und stahlen nur ein wenig .
What about the probability of being caught?	Was ist mit der Wahrscheinlichkeit , erwischt zu werden ?
Some people shredded half the sheet of paper, so there was some evidence left.	Manche haben nur ihr halbes Arbeitsblatt zerrissen es waren also noch Beweise übrig .
Some people shredded the whole sheet of paper.	Andere haben ihr ganzes Arbeitsblatt zerrissen .
Some people shredded everything, went out of the room, and paid themselves from the bowl of money that had over 100 dollars.	Andere haben alles zerrissen und gingen aus dem Zimmer um sich draußen aus einer Geldschale zu bedienen , in der mehr als 100 Dollar lagen .
You would expect that as the probability of being caught goes down, people would cheat more, but again, this was not the case.	Man könnte erwarten , daß Leute häufiger betrügen , sobald die Wahrscheinlichkeit erwischt zu werden , geringer wird - aber wieder war das nicht der Fall .
Again, a lot of people cheated by just by a little bit, and they were insensitive to these economic incentives.	Wieder haben viele Leute nur ein klein wenig betrogen ohne sich dabei um die ökonomischen Anreize zu kümmern .
So we said, "If people are not sensitive to the economic rational theory explanations, to these forces, what could be going on?"	Also fragten wir uns , wenn die Leute offenbar der rationalen Entscheidungstheorie und ihren Kräften nicht unterliegen , was geht hier dann vor sich ?
And we thought maybe what is happening is that there are two forces.	Und wir kamen auf die Idee , daß es ja vielleicht zwei Kräfte gibt .
At one hand, we all want to look at ourselves in the mirror and feel good about ourselves, so we don't want to cheat.	Einerseits wollen wir uns alle im Spiegel betrachten können und uns dabei gut fühlen , also wollen wir nicht betrügen .
On the other hand, we can cheat a little bit, and still feel good about ourselves.	Anderseits könnten wir ein klein wenig schummeln und uns immer noch gut fühlen .
So, maybe what is happening is that there's a level of cheating we can't go over, but we can still benefit from cheating at a low degree, as long as it doesn't change our impressions about ourselves.	Vielleicht ist es ja so , daß es eine gewisse Schummelgrenze gibt die wir nicht übertreten wollen , während wir trotzdem gerne von kleinen Betrügereien profitieren solange diese unser Selbstbild nicht verschlechtern .
We call this like a personal fudge factor.	Wir nennen das den persönlichen Schummelfaktor .
Now, how would you test a personal fudge factor?	Wie kann man so einen Schummelfaktor testen ?
Initially we said, what can we do to shrink the fudge factor?	Zuerst haben wir gesehen , wie man den Fuffziger-Faktor verkleinern kann .
So, we got people to the lab, and we said, "We have two tasks for you today."	Wir haben uns Leute ins Labor geholt und ihnen gesagt , wir hätten zwei Aufgaben für sie .
First, we asked half the people to recall either 10 books they read in high school, or to recall The Ten Commandments, and then we tempted them with cheating.	Zunächst haben wir die Hälfte der Probanden gebeten , 10 Buchtitel aus ihrer Schulzeit aufzuzählen und die anderen , die Zehn Gebote zu rezitieren . Dann haben wir sie in Versuchung geführt , zu schummeln .
Turns out the people who tried to recall The Ten Commandments -- and in our sample nobody could recall all of The Ten Commandments -- but those people who tried to recall The Ten Commandments, given the opportunity to cheat, did not cheat at all.	Interessanterweise hat die Gruppe , die versucht hat die Zehn Gebote zu rezitieren -- in unserem Versuch hat es übrigens niemand geschafft , sich an alle Zehn zu erinnern -- aber die , die versucht haben die Zehn Gebote wiederzugeben , haben , selbst wenn man ihnen die Chance gegeben hat zu betrügen , überhaupt nicht geschummelt .
It wasn't that the more religious people -- the people who remembered more of the Commandments -- cheated less, and the less religious people -- the people who couldn't remember almost any Commandments -- cheated more.	Es war nicht so , daß die religiöseren Personen -- die , die mehr Gebote gewußt haben -- weniger betrogen hätten und daß die weniger religiösen -- diejenigen , die sich an fast gar keine Gebote erinnern konnten -- mehr betrogen hätten .
The moment people thought about trying to recall The Ten Commandments, they stopped cheating.	Es war so , daß alle Probanden , sobald sie sich an die Zehn Gebote erinnern sollten , einfach aufgehört haben zu betrügen .
In fact, even when we gave self-declared atheists the task of swearing on the Bible and we give them a chance to cheat, they don't cheat at all.	Wir haben sogar einige bekennende Atheisten gebeten auf die Bibel zu schwören und ihnen dabei die Möglichkeit gegeben zu schwindeln: sie taten es nicht .
Now, Ten Commandments is something that is hard to bring into the education system, so we said, "Why don't we get people to sign the honor code?"	Die Zehn Gebote sind allerdings nur schwierig mit dem Bildungssystem vereinbar , also haben wir uns überlegt , warum wir nicht von Leuten verlangen , einen Ehrenkodex zu unterschreiben .
So, we got people to sign, "I understand that this short survey falls under the MIT Honor Code."	Also baten wir sie , folgendes zu unterschreiben: "Ich bin mir im Klaren darüber , daß diese Untersuchung dem Ehrenkodex des MIT unterliegt ."
And this is particularly interesting, because MIT doesn't have an honor code.	Das ist vor allem deswegen interessant , weil das MIT überhaupt keinen Ehrenkodex hat .
So, all this was about decreasing the fudge factor.	So haben wir versucht , den Schummelfaktor gering zu halten .
What about increasing the fudge factor?	Wie kann man ihn vergrößern ?
The first experiment -- I walked around MIT and I distributed six-packs of Cokes in the refrigerators -- these were common refrigerators for the undergrads.	Für das erste Experiment bin ich durch das MIT gelaufen und habe Sechserpacks Cola in den Kühlschränken verteilt -- das waren öffentliche Kühlschränke für die Studenten .
And I came back to measure what we technically call the half-lifetime of Coke -- how long does it last in the refrigerators?	Später kam ich zurück um zu messen , was wir im Fachjargon die Halbwertszeit von Cola nennen - wie lange hält sie sich im Kühlschrank ?
As you can expect it doesn't last very long; people take it.	Wie Sie sich vorstellen können , hält sie nicht sehr lange - Leute nehmen sie sich .
In contrast, I took a plate with six one-dollar bills, and I left those plates in the same refrigerators.	Zum Gegensatz dazu nahm ich einen Teller mit sechs Ein-Dollar-Scheinen und stellte solche Teller in die selben Kühlschränke .
No bill ever disappeared.	Kein einziger Geldschein ist jemals verschwunden .
Now, this is not a good social science experiment, so to do it better I did the same experiment as I described to you before.	Das ist aber kein gutes sozialwissenschaftliches Experiment , also haben wir das Experiment von zuvor verbessert und nochmals wiederholt:
A third of the people we passed the sheet, they gave it back to us.	Ein Drittel der Probanden denen wir die Zettel gegeben haben , gab ihn uns zurück
We did not pay them with dollars; we paid them with something else.	Wir haben Ihnen kein Geld gegeben , sondern Marken ,
And then they took the something else, they walked 12 feet to the side, and exchanged it for dollars.	und dann mußten sie diese Marken nehmen und ein paar Meter weiter gehen wo sie sie in echte Dollars eintauschen konnten .
Think about the following intuition.	Denken Sie einmal über das Folgende nach:
How bad would you feel about taking a pencil from work home, compared to how bad would you feel about taking 10 cents from a petty cash box?	Wie schlecht fühlen Sie sich , wenn sie einen Stift von Ihrer Arbeit mit nach Hause nehmen und wie schlecht wenn sie 10 cent aus einer Kleingelddose stehlen ?
These things feel very differently.	Diese Dinge fühlen sich sehr unterschiedlich an .
Would being a step removed from cash for a few seconds by being paid by token make a difference?	Wenn man also für ein paar Sekunden nicht direkt an Geld denkt weil man eine Marke bekommt , macht das einen Unterschied ?
Our subjects doubled their cheating.	Unsere Testpersonen haben doppelt so viel betrogen .
I'll tell you what I think about this and the stock market in a minute.	Ich werde Ihnen gleich erzählen was ich darüber und über die Börse denke .
But this did not solve the big problem I had with Enron yet, because in Enron, there's also a social element.	Aber das hat das größte Problem noch nicht gelöst , das ich in Enron sah , da Enron nämlich ein zusätzliches soziales Element besaß:
People see each other behaving.	Denn Leute können ihr Verhalten gegenseitig beobachten .
In fact, every day when we open the news we see examples of people cheating.	Es ist doch so , daß wir jeden Tag wenn wir die Zeitung öffnen Menschen sehen , die betrügen .
What does this cause us?	Was bedeutet das für uns ?
So, we did another experiment.	Wir dachten uns also ein neues Experiment aus .
We got a big group of students to be in the experiment, and we prepaid them.	Wir haben jede Menge Studenten rekrutiert , an dem Experiment teilzunehmen und sie im Voraus bezahlt .
The same thing happens.	Das Gleiche ist passiert .
When we give people the opportunity to cheat, they cheat.	Wenn wir Menschen die Gelegenheit geben zu betrügen , betrügen sie auch .
They cheat just by a little bit, all the same.	Sie betrügen nur ein klein wenig , aber immerhin .
But in this experiment we also hired an acting student.	Wir haben für dieses Experiment aber auch einen Schauspielschüler engagiert .
So, now we had a student -- an acting student -- that was a part of the group.	Wir hatten also einen Studenten -- einen Schauspielstudenten -- eingeschleust , und ihn zu einem Teil dieser Gruppe gemacht
Nobody knew it was an actor.	in der niemand wußte , daß er ein Schauspieler war .
And they clearly cheated in a very, very serious way.	Und nun hat diese Person ganz offensichtlich einen dreisten Betrug begangen .
What would happen to the other people in the group?	Wie würden die anderen Personen in der Gruppe reagieren ?
Will they cheat more, or will they cheat less?	Würden sie weniger schummeln oder mehr schummeln ?
Here is what happens.	Das Folgende ist passiert:
It turns out it depends on what kind of sweatshirt they're wearing.	Es hat sich herausgestellt daß es davon abhängt , was für ein Sweatshirt man trägt .
Here is the thing.	Es ist nämlich so:
We ran this at Carnegie Mellon and Pittsburgh.	Wir haben dieses Experiment an mehreren Unis durchgeführt .
And at Pittsburgh there are two big universities, Carnegie Mellon and University of Pittsburgh.	Es gibt zwei große Universitäten in Pittsburgh , Die Carnegie Mellon und die University of Pittsburgh .
All of the subjects sitting in the experiment were Carnegie Mellon students.	Alle Testpersonen im Experiment studierten an der Carnegie Mellon .
When the actor who was getting up was a Carnegie Mellon student -- he was actually a Carnegie Mellon student -- but he was a part of their group, cheating went up.	Wenn der Schauspieler auch einen Carnegie Mellon-Studenten spielte -- Er war übrigens tatsächlich ein Carnegie Mellon-Student -- solange er also Teil der Gruppe war , wurde mehr gemogelt .
But when he actually had a University of Pittsburgh sweatshirt, cheating went down.	Sobald er allerdings ein Sweatshirt der University of Pittsburgh anhatte wurde weniger betrogen !
So it wasn't so much about the probability of being caught again.	Es ging hier also nicht um die Wahrscheinlichkeit , beim Betrug erwischt zu werden .
It was about the norms for cheating.	Es ging vielmehr darum , wann Betrug normativ akzeptiert wird .
If somebody from our in-group cheats and we see them cheating, we feel it's more appropriate, as a group, to behave this way.	Wenn jemand aus unserer Wir-Gruppe betrügt und wir ihn dabei sehen so haben wir als Gruppe das Gefühl , daß dieses Verhalten relativ angemessen ist .
But if it's somebody from another group, these terrible people -- I mean, not terrible in this -- but somebody we don't want to associate ourselves with, from another university, another group, all of a sudden people's awareness of honesty goes up -- a little bit like The Ten Commandments experiment -- and people cheat even less.	Wenn es aber jemand aus einer anderen Gruppe ist , einer dieser schrecklichen Leute -- Ich meine damit niemand bestimmten -- aber jemand mit dem wir uns nicht identifizieren wollen , jemand von einer anderen Universität , aus einer anderen Gruppe , dann wird Ehrlichkeit von Menschen plötzlich viel stärker wahrgenommen -- ein bißchen wie bei dem Zehn-Gebote-Experiment -- und es wird viel weniger gemogelt .
So, what have we learned from this about cheating?	Was haben wir davon also über das Betrügen gelernt ?
We've learned that a lot of people can cheat.	Wir haben gelernt , daß viele Leute betrügen können .
They cheat just by a little bit.	Der Einzelne betrügt dabei nur ein bißchen .
When we remind people about their morality, they cheat less.	Sobald wir Leute an ihre Moral erinnern , betrügen sie weniger .
When we get bigger distance from cheating, from the object of money, for example, people cheat more.	Wenn der Betrug sich "weiter entfernt" anfühlt , weil es beispielsweise nur indirekt um Geld geht , betrügen sie mehr .
And when we see cheating around us, particularly if it's a part of our in-group, cheating goes up.	Und wenn wir sehen wie um uns herum geschummelt wird , vor allem wenn es ein Teil unserer Wir-Gruppe tut , dann schummeln wir mehr .
Now, if we think about this in terms of the stock market, think about what happens.	Wenn wir das jetzt auf die Börse anwenden , was sehen wir dann ?
What happens in a situation when you create something where you pay people a lot of money to see reality in a slightly distorted way?	Was passiert , wenn man etwas erschaffen hat das Menschen sehr viel Geld dafür bezahlt , die Wirklichkeit auf eine etwas verzerrte Art wahrzunehmen ?
Would they not be able to see it this way?	Wären sie nicht in der Lage , es auch so zu sehen ?
Of course they would.	Natürlich wären sie das .
What happens when you do other things, like you remove things from money?	Was passiert wenn man andere Dinge tut , wie zum Beispiel Dinge weiter und weiter von Geld zu entfernen ?
You call them stock, or stock options, derivatives, mortgage-backed securities.	Wir haben Aktien , Aktienoptionen , Derivative , Hypothekengestützte Wertpapiere .
Could it be that with those more distant things, it's not a token for one second, it's something that is many steps removed from money for a much longer time -- could it be that people will cheat even more?	Ist es möglich , daß diese weiter entfernten Dinge , die keine Sekunde lang etwas reales repräsentieren , die so viele Umwandlungsschritte von Geld entfernt sind und es für so lange Zeit bleiben -- könnte es sein , daß Leute bei solchen Dingen sehr viel mehr betrügen ?
And what happens to the social environment when people see other people behave around them?	Und was passiert mit einem gesellschaftlichen Umfeld in dem Leute ständig das Verhalten ihrer Nächsten sehen ?
I think all of those forces worked in a very bad way in the stock market.	Ich denke daß alle diese Kräfte sehr schlechte Auswirkungen auf die Börse haben .
More generally, I want to tell you something about behavioral economics.	Etwas genereller wollte ich Ihnen etwas über Verhaltensökonomie erzählen .
We have many intuitions in our life, and the point is that many of these intuitions are wrong.	Oft lassen wir uns von unserer Intuition leiten -- die Sache ist daß diese Intuition oft falsch ist .
The question is, are we going to test those intuitions?	Die Frage ist , ob wir unserer Intuition nachgeben wollen oder sie erst auf die Probe stellen .
We can think about how we're going to test this intuition in our private life, in our business life, and most particularly when it goes to policy, when we think about things like No Child Left Behind, when you create new stock markets, when you create other policies -- taxation, health care and so on.	Wir können uns überlegen , wie wir solche Intuitionen sowohl in unserem Privatleben als auch geschäftlich testen können . Am wichtigsten ist dabei wohl die Politik , man denke einmal an Dinge wie die Amerikanische Bildungsreform von 2001 oder die Schaffung neuer Börsenmärkte , oder andere politische Entscheidungen wie Steuerpolitik , Gesundheitswesen und so weiter und so fort .
And the difficulty of testing our intuition was the big lesson I learned when I went back to the nurses to talk to them.	Wie schwierig es ist , unsere Intuition zu hinterfragen habe ich deutlich sehen können als ich ins Krankenhaus zurückging um meine Krankenschwestern wiederzusehen .
So I went back to talk to them and tell them what I found out about removing bandages.	Ich ging zurück um mit ihnen zu reden und ihnen zu erzählen , was ich über das Abnehmen von Verbänden gelernt hatte .
And I learned two interesting things.	Dabei habe ich zwei interessante Dinge gelernt:
One was that my favorite nurse, Ettie, told me that I did not take her pain into consideration.	Erstens hat meine Lieblingsschwester Ettie mir gesagt , ich hätte ihren Schmerz nicht in die Untersuchung einbezogen .
But think about me as a nurse, taking, removing the bandages of somebody I liked, and had to do it repeatedly over a long period of time.	Aber denken Sie einmal an mich als Krankenschwester . Ich mußte jemandem den ich mochte die Verbände wechseln -- und das immer und immer wieder über einen sehr langen Zeitraum .
And she said maybe part of the reason was it was difficult for her.	Und dann sagte sie mir vielleicht einen Teil des Grundes , weswegen es für sie schwer war --
So, if you think about all of your intuitions, it's very hard to believe that your intuition is wrong.	Wenn Sie jetzt einmal über jede Ihrer Eingebungen nachdenken , ist es sehr schwer , zu glauben , daß Ihre Intuition sie trügt .
And she said, "Given the fact that I thought my intuition was right ..." -- she thought her intuition was right -- it was very difficult for her to accept doing a difficult experiment to try and check whether she was wrong.	Und sie sagte , weil ich dachte , meine Intuition wäre richtig -- und sie dachte ihre Intuition wäre richtig -- wäre es sehr schwierig für sie , ein schwieriges Experiment zu veranstalten nur um zu überprüfen , ob sie falsch lag .
But in fact, this is the situation we're all in all the time.	Das ist aber tatsächlich die Situation in der wir uns alle die ganze Zeit befinden .
We have very strong intuitions about all kinds of things -- our own ability, how the economy works, how we should pay school teachers.	Unsere Intuition spricht über alles Mögliche zu uns -- über unsere eigenen Fähigkeiten , wie die Wirtschaft funktioniert , darüber , wie gut wir Lehrer bezahlen sollten .
But unless we start testing those intuitions, we're not going to do better.	Aber solange wir nicht anfangen , diese Eingebungen auf die Probe zu stellen , werden wir es nie besser machen als jetzt .
And just think about how better my life would have been if these nurses would have been willing to check their intuition, and how everything would have been better if we just start doing more systematic experimentation of our intuitions.	Denken Sie einmal darüber nach , wieviel höher meine Lebensqualität gewesen wäre , wenn meine Krankenschwestern bereit gewesen wären , ihre Intuition zu hinterfragen und um wieviel besser unser aller Leben sein könnte , wenn wir nur anfingen , unsere Intuitionen durch systematische Experimente zu überprüfen .
Thank you very much.	Vielen Dank .
Today I am going to teach you how to play my favorite game: massively multiplayer thumb-wrestling.	Heute werde ich Ihnen beibringen , wie man mein Lieblingsspiel spielt: Massen-Mehrspieler-Daumenringen .
